a	ɒ
á	aː
b	b
c	t͡s
cs	t͡ʃ
d	d
dz	d͡z
dzs	d͡ʒ
e	ɛ
ë	e
é	eː
f	f
g	ɡ
gy	ɟ
h	h
i	i
í	iː
j	j
k	k
l	l
ly	j
m	m
n	n
ny	ɲ
o	o
ó	oː
ö	ø
ő	øː
p	p
qu	kv
r	r
s	ʃ
sz	s
t	t
ty	c
u	u
ú	uː
ü	y
ű	yː
v	v
w	v
x	ks
y	i
z	z
zs	ʒ
