а	a
б	b
в	v
г	ɡ
д	d
е	e
ё	o
ж	ʒ
з	z
и	i
й	j
к	k
л	l
м	m
н	n
о	o
п	p
р	r
с	s
т	t
у	u
ф	f
х	x
ц	t͡s
ч	t͡ɕ
ш	ʂ
щ	ɕː
ъ
ы	ɨ
ь	ʲ
э	e
ю	u
я	a
дж	d͡ʒ
