άγγελοσ	/aŋɟɛlɔs/	wiki
άγιε	/aʝe/	wiki
άγχοσ	/aŋxɔs/	wiki
άθυρμα	/aθiɾma/	wiki
άλφα	/alfa/	wiki
άμεσοσ	/amɛsɔs/	wiki
άνδρασ	/anðras/	wiki
άνθοσ	/anθɔs/	wiki
άντρασ	/andras/	wiki
άπαπα	/apapa/	wiki
άργιλοσ	/aɾʝilos/	wiki
άργυροσ	/aɾʝiɾos/	wiki
άρησ	/aris/	wiki
άσφαλτοσ	/asfaltos/	wiki
άχυρο	/açiɾo/	wiki
έαρ	/e̞ar/	wiki
ένα	/e̞na/	wiki
ένασ	/e̞nas/	wiki
ένρινοσ	/en̪rinos/	wiki
έξη	/ɛksi/	wiki
έξι	/ɛksi/	wiki
έξυπνοσ	/ɛksipnɔs/	wiki
έπιπλο	/e̞piplo̞/	wiki
ήλιο	/ilio/	wiki
ήλιο	/iʎo/	wiki
ήλιον	/ilion/	wiki
ήμαρτον	/imaɾton/	wiki
ήρα	/ira/	wiki
ίσισ	/isis/	wiki
α.α.	/alfaalfa/	wiki
αίμα	/ema/	wiki
αίνιγμα	/ɛniɣma/	wiki
αίσιοσ	/ɛsiɔs/	wiki
αγάπη	/aɣapi/	wiki
αγγαρεία	/aŋɡaɾia/	wiki
αγγελία	/aŋɟelia/	wiki
αγγελτήριο	/aŋɟeltirio/	wiki
αγκάθι	/aŋɡaθi/	wiki
αγκομαχητό	/aŋɡomaçito/	wiki
αγκώνασ	/aŋɡonas/	wiki
αγοριού	/aɣɔɾʝu/	wiki
αγοριών	/aɣɔɾʝɔn/	wiki
αγριόπαπια	/aɣrio̞papça/	wiki
αγόρια	/aɣɔɾʝa/	wiki
αδύνατοσ	/aðinatos/	wiki
αινίγματα	/ɛniɡmata/	wiki
αινίγματα	/ɛniɣmata/	wiki
αινίγματοσ	/ɛniɡmatɔs/	wiki
αινίγματοσ	/ɛniɣmatɔs/	wiki
αινιγμάτων	/ɛniɡmatɔn/	wiki
αινιγμάτων	/ɛniɣmatɔn/	wiki
αινιγματικόσ	/ɛniɣmatikɔs/	wiki
ακαριαίοσ	/akaɾiɛɔs/	wiki
ακούω	/akuo/	wiki
αλάτι	/alati/	wiki
αλεύρι	/alevɾi/	wiki
αμέσωσ	/amɛsɔs/	wiki
αμίμητοσ	/amimɛtɔs/	wiki
ανάρτηση	/anaɾtisi/	wiki
ανακατάληψη	/ɐnɐkɐtɐʎipsi/	wiki
ανακαταλαμβάνω	/ɐnɐkɐtɐlɐɱvɐno̞/	wiki
ανατομία	/anatɔmia/	wiki
ανδροπρεπήσ	/anðroprepis/	wiki
ανθοκομία	/anatɔmia/	wiki
ανθρωποφάγοσ	/anθɾɔpɔfaɣɔs/	wiki
αντικλεπτικόσ	/andikleptikos/	wiki
ανωμαλία	/anɔmalia/	wiki
απάτη	/apati/	wiki
απατεώνασ	/apatɛɔnas/	wiki
απατηλόσ	/apatilɔs/	wiki
απιστία	/apistia/	wiki
απλόσ	/aplɔs/	wiki
απλώσ	/aplɔs/	wiki
απόστροφοσ	/apɔstɾɔfɔs/	wiki
απόψε	/apopse/	wiki
αρχιεπίσκοποσ	/arçiepiskopos/	wiki
αρχισυντάκτησ	/arçisindaktis/	wiki
ασθένεια	/asθɛnia/	wiki
αστείο	/astiɔ/	wiki
αστρολογία	/astɾɔlɔʝia/	wiki
αυνανισμόσ	/avnanismɔs/	wiki
αυτοκίνητο	/aftokinito/	wiki
αυτόγραφο	/aftɔɣɾafɔ/	wiki
αφθώδησ	/afθoðis/	wiki
αφοπλισμόσ	/afɔplizmɔs/	wiki
αχάτησ	/axatis/	wiki
βάσεισ	/vasis/	wiki
βαθυκύανο	/vaθiciano̞/	wiki
βιβλίο	/vivlio/	wiki
βλέπομαι	/vlepome/	wiki
βλέπω	/vlepo/	wiki
βοηθητικόσ	/vɔiθitikɔs/	wiki
βουνό	/vuno/	wiki
βρέχει	/vreçi/	wiki
βραδινόσ	/vɾaðinos/	wiki
βροχή	/vɾoçi/	wiki
γάλα	/ɣala/	wiki
γίγαντασ	/ʝiɣɐdɐs/	wiki
γίνομαι	/ʝinome/	wiki
γαλλία	/ɣɐlˑiɐ/	wiki
γαμήσου	/ɣamisu/	wiki
γαμηθείτε	/ɣamiθite/	wiki
γεμάτοσ	/ʝe̞mato̞s/	wiki
γενναίοσ	/ʝeneos/	wiki
γη	/ʝi/	wiki
για	/ʝa/	wiki
γιαούρτι	/ʝauɾti/	wiki
γιόντα	/ʝoda/	wiki
γνωστικισμόσ	/ɣnɔsticismɔs/	wiki
γροθιά	/ɣroθça/	wiki
γυμνόσ	/ʝimnɔs/	wiki
γυμνότητα	/ʝimnɔtita/	wiki
γυναίκα	/ʝine̞ka/	wiki
γόνατο	/ɣɔnatɔ/	wiki
δάσοσ	/ðasɔs/	wiki
δέκα	/ðe̞ka/	wiki
δέντρο	/ðe̞ndro̞/	wiki
δέρμα	/ðɛɾma/	wiki
δε	/ðe̞/	wiki
δεκάξι	/ðekaksi/	wiki
δεκαέξι	/ðekaeksi/	wiki
δεκαεπτά	/ðekaepta/	wiki
δεκαεφτά	/ðekaefta/	wiki
δεκαοκτώ	/ðekaokto/	wiki
δεκαοχτώ	/ðekaoxto/	wiki
δημιουργία	/ðimiuɾʝia/	wiki
δημόσιοσ	/ðimosios/	wiki
διάβολοσ	/ðiavolos/	wiki
διάβολοσ	/ðʝavolos/	wiki
διάλοσ	/ðialos/	wiki
διάλοσ	/ðʝalos/	wiki
διάολοσ	/ðiaolos/	wiki
διάολοσ	/ðʝaolos/	wiki
διαλέγομαι	/ðialeɣome/	wiki
διαλέγομαι	/ðʝaleɣome/	wiki
διαλέγω	/ðʝaleɣo/	wiki
διαμάντι	/ðiamandi/	wiki
δουλειά	/ðulja/	wiki
δρύπη	/ðɾipi/	wiki
δυο	/ðʝo/	wiki
δυστυχία	/ðistiçia/	wiki
δόντι	/ðɔndi/	wiki
δύω	/ðio/	wiki
είκοσι	/ikɔsi/	wiki
εγχειρίδιο	/eŋçiriðio/	wiki
εδώ	/e̞ðo̞/	wiki
ειδοποιόσ	/iðopços/	wiki
εικοσάδα	/ikɔsaða/	wiki
ειλικρινήσ	/ilikɾinis/	wiki
εισ	/is/	wiki
εκατοντάδα	/ekatodaða/	wiki
εκγύμναση	/ekʝimnasi/	wiki
εκεί	/e̞ci/	wiki
εκχιονιστήρασ	/ekçionistiras/	wiki
ελληνικά	/eʎiɲika/	wiki
εμείσ	/e̞mis/	wiki
εν	/en/	wiki
ενενήντα	/eneninda/	wiki
εξήντα	/eksinda/	wiki
επικόσ	/ɛpikɔs/	wiki
ερίφιο	/erifɪo/	wiki
ερωτικόσ	/ɛrɔtikɔs/	wiki
εσείσ	/e̞sis/	wiki
εσύ	/e̞si/	wiki
ευγενικόσ	/ɛvʝɛnikɔs/	wiki
ευγνωμοσύνη	/ɛvɣnɔmɔsini/	wiki
ζήτηση	/zitisi/	wiki
ζαφείρι	/zafiri/	wiki
ζεστόσ	/ze̞sto̞s/	wiki
ζουρνάσ	/zuɾnas/	wiki
θάλασσα	/θalasa/	wiki
θάνατοσ	/θanatos/	wiki
θείοσ	/θiɔs/	wiki
θηλή	/θili/	wiki
θηλυπρεπήσ	/thiliprepis/	wiki
θρησκεία	/θriskia/	wiki
ισραήλ	/izɾail/	wiki
ιώ	/io/	wiki
καμήλα	/kamila/	wiki
καράβι	/karavi/	wiki
καράβια	/karavʝa/	wiki
καρυδιά	/kariðʝa/	wiki
καταλαβαίνω	/katalavɛnɔ/	wiki
καφετιέρα	/kafetçera/	wiki
κεφάλι	/ce̞fali/	wiki
κεφαλή	/ce̞fali/	wiki
κηλίδα	/ciliða/	wiki
κινηματογραφικόσ	/cinimatɔɣɾafikɔs/	wiki
κλίνω	/klino/	wiki
κλείνω	/klino/	wiki
κλειδί	/kliði/	wiki
κλειτορίδα	/klitɔɾiða/	wiki
κλουβί	/kluvi/	wiki
κολιμπρί	/kɔlibɾi/	wiki
κολλέγιο	/koleʝio/	wiki
κολοτούμπα	/kolotumba/	wiki
κοντά	/ko̞nda/	wiki
κουβέρτα	/kuvɛɾta/	wiki
κουδούνι	/kuðuni/	wiki
κουνιάδοσ	/kuɲaðos/	wiki
κρεβάτι	/kɾɛvati/	wiki
κυκλική	/ciklici/	wiki
κωλαράκι	/kolaɾaki/	wiki
κωλαράκοσ	/kolaɾakos/	wiki
κωλοτούμπα	/kolotumba/	wiki
κόκαλο	/kokalo/	wiki
κώλοσ	/kolos/	wiki
λάρυγγασ	/laɾiŋɡas/	wiki
λίπανση	/lipansi/	wiki
λαμβάνω	/lɐɱvɐno̞/	wiki
λεονάρδοσ	/lɛɔnaɾðɔs/	wiki
λεωνάρδοσ	/lɛɔnaɾðɔs/	wiki
λινάρι	/linaɾi/	wiki
λιπαίνω	/lipɛnɔ/	wiki
λιπαντικό	/lipandikɔ/	wiki
λιπαντικόσ	/lipandikɔs/	wiki
λογικά	/lɔʝika/	wiki
λογική	/lɔʝici/	wiki
λογικήσ	/lɔʝicis/	wiki
λουλούδι	/luluði/	wiki
λωτόσ	/lɔtɔs/	wiki
λόγοσ	/loɣos/	wiki
λύκαινα	/likena/	wiki
μάγοσ	/mɐɣo̞s̠/	wiki
μάτι	/mati/	wiki
μαγειρική	/maʝiɾici/	wiki
μακριά	/makria/	wiki
μαλακία	/malacia/	wiki
μαλαπέρδα	/malaperða/	wiki
μαλλιά	/maʎa/	wiki
μαμά	/mama/	wiki
μαμίσιοσ	/mamisços/	wiki
μαραγκόσ	/mɐɾɐŋɡo̞s̠/	wiki
μαριχουάνα	/maɾiχwana/	wiki
μασχάλεσ	/masxalɛs/	wiki
μασχάλησ	/masxalis/	wiki
μασχαλών	/masxalɔn/	wiki
μαύροσ	/mavros/	wiki
με	/me̞/	wiki
μεξικού	/me̞k͡s̠iku/	wiki
μεξικό	/me̞k͡s̠iko̞/	wiki
μετά	/me̞ta/	wiki
μετάφραση	/mɛtafɾasi/	wiki
μηχανή	/mixɐɲi/	wiki
μικροσκόπιο	/mikroskopio/	wiki
μικρόσ	/mikro̞s/	wiki
μορφίνη	/mɔɾfini/	wiki
μουσακάσ	/musakas/	wiki
μουσική	/musici/	wiki
μούρη	/muɾi/	wiki
μούτρο	/muɾi/	wiki
μπίρα	/bira/	wiki
μπουγάτσα	/buɣatsa/	wiki
μπριζόλα	/brizo̞la/	wiki
μπύρα	/bira/	wiki
μυστήριο	/mistiɾiɔ/	wiki
μυστηριώδησ	/mistiɾiɔðis/	wiki
νέοσ	/ne̞o̞s/	wiki
ναίκα	/ne̞ka/	wiki
ναι	/ne̞/	wiki
ναρκωτικό	/naɾkɔtikɔ/	wiki
ναρκωτικόσ	/naɾkɔtikɔs/	wiki
ναυαγοσώστησ	/navaɣɔsɔstis/	wiki
νερομάνα	/ne̞ro̞mana/	wiki
νύχι	/niçi/	wiki
νύχτα	/nixta/	wiki
νύχτα	/ɲixta/	wiki
ξέρω	/ksɛɾɔ/	wiki
ξανά	/ksana/	wiki
ξουτ	/ksut/	wiki
ξυλουργόσ	/ks̠ilurɣo̞s̠/	wiki
ογδόντα	/oɣðonda/	wiki
οδόσ	/oðos/	wiki
οικοδομή	/ikɔðɔmi/	wiki
ομοφυλοφιλία	/ɔmɔfilɔfilia/	wiki
ομοφυλοφιλίασ	/ɔmɔfilɔfilias/	wiki
ονείρου	/ɔniru/	wiki
ονείρων	/ɔnirɔn/	wiki
οξύθυμοσ	/ɔksiθimɔs/	wiki
ορχιδέα	/ɔɾçiðɛa/	wiki
οστό	/o̞sto̞/	wiki
ουρανόσ	/uranos/	wiki
ουσιαστικό	/usiastikɔ/	wiki
π.χ.	/pici/	wiki
π.χ.	/puxu/	wiki
πάθοσ	/paθos/	wiki
πάλη	/pali/	wiki
πάλι	/pali/	wiki
πέντε	/pe̞nde̞/	wiki
παιχνίδι	/pe̞xniði/	wiki
πανεπιστήμιο	/panepistimio/	wiki
παράδεισοσ	/paraðisɔs/	wiki
παράθυρο	/paɾaθiɾɔ/	wiki
παράφωνοσ	/paɾafonos/	wiki
παραίσθηση	/parɛsθisi/	wiki
παραίσθησησ	/parɛsθisis/	wiki
παραισθήσεισ	/parɛsθisis/	wiki
παραισθήσεων	/parɛsθisɛɔn/	wiki
παραισθήσεωσ	/parɛsθisɛɔs/	wiki
παρανομιάζω	/paranomɲazo/	wiki
παραφωνία	/paɾafonia/	wiki
πατήρ	/patir/	wiki
πεθαίνω	/peθeno/	wiki
πειράζω	/piɾazo/	wiki
περίνεο	/pɛrinɛɔ/	wiki
περίπλοκοσ	/pɛɾiplɔkɔs/	wiki
πιγούνι	/piɣuni/	wiki
πιο	/pço/	wiki
πλάτων	/platɔn/	wiki
πλήρησ	/pliris/	wiki
ποιοσ	/pços/	wiki
πορδούλα	/poɾðula/	wiki
πορνείο	/pɔɾniɔ/	wiki
πορνογράφοσ	/pɔrnɔɣɾafɔs/	wiki
πορνογραφία	/pɔrnɔɣrafia/	wiki
πορνογραφικόσ	/pɔrnɔɣrafikɔs/	wiki
πορτοκαλάδα	/pɔɾtɔkalaða/	wiki
πορτρέτο	/po̞rtre̞to̞/	wiki
πορτραίτο	/po̞rtre̞to̞/	wiki
πουλιά	/puʎa/	wiki
προσωπικότητα	/pɾɔsɔpikɔtita/	wiki
προσωπογραφία	/pro̞so̞po̞ɣrafia/	wiki
πυρετόσ	/piɾɛtɔs/	wiki
πόσθη	/pɔsθi/	wiki
ραδιόφωνο	/raðiofono/	wiki
ραντάρ	/ɾadaɾ/	wiki
ρύγχοσ	/riŋxo̞s/	wiki
ρύζι	/ɾizi/	wiki
σάντουιτσ	/sanduits/	wiki
σαμποδρόμιο	/s̠ɐᵐbo̞ðɾo̞mɲ̟o̞/	wiki
σατανάσ	/satanas/	wiki
σε	/sɛ/	wiki
σελίδα	/sɛliða/	wiki
σελίδασ	/sɛliðas/	wiki
σελίδεσ	/sɛliðɛs/	wiki
σελίδων	/sɛliðɔn/	wiki
σεξουαλικόσ	/seksualikɔs/	wiki
σεξουαλικότητα	/seksualikɔtita/	wiki
σιωπηλόσ	/siopilos/	wiki
σκαντζόχοιροσ	/s̠kɐⁿd͡z̠o̞çiɾo̞s̠/	wiki
σκατουλάκι	/skatulaki/	wiki
σκατουλίτσα	/skatulitsa/	wiki
σκατούλι	/skatuli/	wiki
σκηνή	/scini/	wiki
σκοινί	/scini/	wiki
σπόροσ	/spo̞ro̞s/	wiki
στάση	/stasi/	wiki
στραβομουτσουνιάζω	/stɾavomut͡suɲazo/	wiki
στύση	/stisi/	wiki
συγγένεια	/siŋɟenia/	wiki
συγγενικόσ	/siŋɟɛnikɔs/	wiki
συκώτι	/siko̞ti/	wiki
συνεργόσ	/sinerɣos/	wiki
σχήμα	/sçima/	wiki
σχιζοφρένεια	/sçizofɾeɲa/	wiki
σωστόσ	/so̞sto̞s/	wiki
τέκνο	/tɛknɔ/	wiki
τέσσερα	/tesera/	wiki
τέσσερεισ	/te̞se̞ɾis/	wiki
τέσσερισ	/te̞se̞ɾis/	wiki
ταμειακόσ	/tɐmʝɐko̞s/	wiki
τεμπέλησ	/tɛbɛlis/	wiki
τηγανίζω	/tiɣanizo/	wiki
τρένο	/tre̞no̞/	wiki
τρία	/tria/	wiki
τραίνο	/tre̞no̞/	wiki
τραγούδι	/traɣuði/	wiki
τραγόπαπασ	/tɾaɣopapas/	wiki
τρελαίνω	/tɾeleno/	wiki
τροία	/tria/	wiki
τροφή	/tɾɔfi/	wiki
τσιγάρο	/tsiɣarɔ/	wiki
τσουτσούνι	/tsutsuni/	wiki
τσούλα	/t͡sula/	wiki
υπερφυσικόσ	/ipɛɾfisikɔs/	wiki
φέγγω	/feŋɡo/	wiki
φαλάκρα	/falakra/	wiki
φαλλικόσ	/falikɔs/	wiki
φαλλόσ	/falɔs/	wiki
φεγγάρι	/fe̞ŋɡɐ̞ri/	wiki
φθινόπωρο	/fθino̞po̞ro̞/	wiki
φι	/fi/	wiki
φλόγα	/flɔɣa/	wiki
φταίω	/fteo/	wiki
φωτιά	/fotça/	wiki
φωτόνιο	/fotonio/	wiki
χέμινγουεϊ	/çemiŋɣuei/	wiki
χείμαρρε	/çimaɾe/	wiki
χείμαρρο	/çimaɾo/	wiki
χείμαρροι	/çimaɾi/	wiki
χείμαρροσ	/çimaɾos/	wiki
χείμαρρου	/çimaɾu/	wiki
χείμαρρουσ	/çimaɾus/	wiki
χείμαρρων	/çimaɾon/	wiki
χειμάρρου	/çimaɾu/	wiki
χειμάρρουσ	/çimaɾus/	wiki
χειμώνασ	/çimo̞nas/	wiki
χριστιανοσύνη	/xɾistçanosini/	wiki
χύνω	/çino/	wiki
ψάρι	/p͡sari/	wiki
ψευδοπάτωμα	/psɛvðɔpatɔma/	wiki
ψυχή	/psiçi/	wiki
ψυχολογία	/psixɔlɔʝia/	wiki
ωκεανόσ	/oceanos/	wiki
όλοσ	/o̞lo̞s/	wiki
όνειρα	/ɔnira/	wiki
όνειρο	/ɔnirɔ/	wiki
όροσ	/o̞ro̞s/	wiki
όρχισ	/oɾçis/	wiki
όσχεο	/osçeo/	wiki
όχι	/o̞çi/	wiki
