'ndrangheta	n̪d̪r̺äŋɡe̞t̪ä	wiki
'ndranghetista	n̪d̪r̺äŋɡe̞t̪is̪t̪ä	wiki
'ndrina	n̪d̪r̺iːn̺ä	wiki
'nduja	n̪d̪uːjä	wiki
'sto	s̪t̪o	wiki
a	ä	wiki
a'	ä	wiki
aaleniano	äl̺en̺jäːn̺o	wiki
abachista	äbäk̟is̪t̪ä	wiki
abaco	äːbäko̞	wiki
abacà	äbäkä	wiki
abadia	äbäd̪iːä	wiki
abalienare	äbäl̺jen̺äːr̺e̞	wiki
abalienazione	äbäljen̺ät̪͡s̪joːn̺e	wiki
abalietà	äbäl̺jet̪ä	wiki
abantico	äbän̪t̪iːko	wiki
abarico	äbäːr̺iko	wiki
abarognosia	äbär̺o̞ɲɲoz̪iːä	wiki
abasia	äbäziä̯	wiki
abassiale	äbäs̪s̪jäːl̺e̞	wiki
abato	äːbät̪o̞	wiki
abaton	äːbät̪o̞n̺	wiki
abatterico	äbät̪t̪ɛːr̺iko	wiki
abavo	äːbävo̞	wiki
abbacchiaro	äbbäkkjäːr̺o̞	wiki
abbacchio	äbbäkk̟jo	wiki
abbachista	abbakis̪t̪a	wiki
abbaco	äbbäko̞	wiki
abbadia	äbbäd̪iä̯	wiki
abbadia	äbbäd̪iːä	wiki
abbadiana	äbbäd̪jäːn̺ä	wiki
abbadiano	äbbäd̪jäːn̺o̞	wiki
abbadiense	äbbäd̪iɛn̪s̪e	wiki
abbadiense	äbbäd̪jɛn̪s̪e	wiki
abbadino	äbbäd̪iːn̺o	wiki
abbandonismo	äbbän̪d̪o̞n̺iz̪mo	wiki
abbarbagliamento	äbbär̺bäʎʎäme̞n̪t̪o	wiki
abbarbagliare	äbbär̺bäʎʎäːr̺e̞	wiki
abbarbaglio	äbbär̺bäʎʎo	wiki
abbarbicare	äbbär̺bikäːr̺e̞	wiki
abbaside	äbbäːs̪id̪e	wiki
abbassatura	äbbäs̪s̪ät̪uːr̺ä	wiki
abbasside	äbbäs̪s̪id̪e	wiki
abbate	äbbäːt̪e̞	wiki
abbecedario	äbbe̞t͡ʃed̪äːr̺jo	wiki
abbiamo	abbjaːmo	wiki
abbisognare	äbbiz̪oɲɲäːr̺e̞	wiki
abbominevole	äbːo̞min̺eːvol̺e	wiki
abbonacciare	äbbo̞n̺ätt͡ʃäːr̺e̞	wiki
abbonare	äbːo̞n̺äːr̺e̞	wiki
abbonarsi	äbːo̞n̺är̺s̪i	wiki
abbondevole	äbbo̞n̪d̪eːvol̺e	wiki
abbronzare	äbbr̺o̞n̪d̪͡z̪äːr̺e̞	wiki
abbronzarsi	äbbr̺o̞n̪d̪͡z̪är̺s̪i	wiki
abderita	äbd̪e̞r̺iːt̪ä	wiki
abecedario	äbe̞t͡ʃed̪äːr̺jo	wiki
abelmosco	äbe̞l̺mɔs̪ko	wiki
abentare	äbe̞n̪t̪äːr̺e̞	wiki
abento	äbɛn̪t̪o	wiki
abiezione	äbjet̪t̪͡s̪joːn̺e	wiki
abigeatario	äbid͡ʒeät̪äːr̺jo	wiki
abigeato	äbid͡ʒeäːt̪o̞	wiki
abisso	äbis̪s̪o	wiki
abnorme	äbn̺ɔr̺me	wiki
abominando	äbo̞min̺än̪d̪o̞	wiki
abominevole	äbo̞min̺eːvol̺e	wiki
abondevole	äbo̞n̪d̪eːvol̺e	wiki
abramo	äbr̺äːmo̞	wiki
abrotanino	äbr̺o̞t̪än̺iːn̺o	wiki
abulia	äbul̺iːa	wiki
acagiù	äkäd͡ʒu	wiki
acanzio	äkän̪t̪͡s̪jo	wiki
acato	äːkät̪o̞	wiki
acazio	äkät̪t̪͡s̪jo	wiki
acca	äkːä	wiki
accappatoio	äkːäpːät̪oːjo	wiki
accapricciare	äkkäpr̺itt͡ʃäːr̺e̞	wiki
accendisigaro	ätt͡ʃɛn̪d̪is̪iːɡär̺o̞	wiki
accetta	ätt͡ʃe̞t̪ːä	wiki
accetta	ätt͡ʃɛt̪ːä	wiki
acchito	äkk̟iːt̪o	wiki
acciaiare	ätt͡ʃäjäːr̺e̞	wiki
acciaiatura	ätt͡ʃäjät̪uːr̺ä	wiki
acciaio	ätt͡ʃäːjo	wiki
acciaiolo	ätt͡ʃäjɔːl̺o	wiki
acciaiuolo	ätt͡ʃäjwɔːl̺o	wiki
acciarino	ätt͡ʃär̺iːn̺o	wiki
acciocché	at͡ːʃokk̟e	wiki
acciuga	ätt͡ʃuːɡä	wiki
acciughero	ätt͡ʃuːɡer̺o	wiki
acciughetta	ätt͡ʃuɡet̪t̪ä	wiki
acciughina	ätt͡ʃuɡ̟iːn̺ä	wiki
acciò	att͡ʃɔ	wiki
accontentare	äkko̞n̪t̪en̪t̪äːr̺e̞	wiki
acheronteo	äke̞r̺on̪t̪ɛːo	wiki
acido	aːtʃid̪o	wiki
acqua	äkkwä	wiki
acquaiolo	äkkwäjɔːl̺o	wiki
acquaiuolo	äkkwäjwɔːl̺o	wiki
acquare	äkkwär̺e̞	wiki
acquascooter	äkkwäs̪kuːt̪er̺	wiki
acquazzone	äkkwät̪t̪͡s̪o̞ːn̺e	wiki
acqueo	äkkweo	wiki
acqueo	äkkwe̯o	wiki
acquiescente	äkkwjeʃʃɛn̪t̪e	wiki
acquiescentemente	äkkwjeʃʃen̪t̪emen̪t̪e	wiki
acquiescenza	äkkwjeʃʃɛn̪t̪͡s̪ä	wiki
acquiescere	äkkwiɛʃʃer̺e	wiki
acquietare	äkkwjet̪äːr̺e̞	wiki
acquietarsi	äkkwjet̪är̺s̪i	wiki
adacquare	äd̪äkkwäːr̺e̞	wiki
adalberto	äd̪äl̺bɛr̺t̪o	wiki
addiettivo	äd̪d̪jet̪t̪iːvo	wiki
addogliare	äd̪d̪o̞ʎʎäːr̺e̞	wiki
adduare	äd̪d̪uäːr̺e̞	wiki
adduarsi	äd̪d̪uär̺s̪i	wiki
ade	äːd̪e̞	wiki
adeano	äd̪e̞äːn̺o̞	wiki
adele	äd̪ɛːle	wiki
adenina	ad̪e̞n̺iːn̺a	wiki
adenosina	ad̪en̺os̪iːn̪a	wiki
adenosindifosfato	ad̪en̺oz̪in̪d̪ifos̪faːt̪o	wiki
adenosinfosfato	äd̪e̞n̺oz̪iɱfos̪fäːt̪o̞	wiki
adenosinmonofosfato	ad̪en̺oz̪in̺mon̺ofos̪faːt̪o	wiki
adenosinmonofosfato	ad̪en̺oz̪in̺mɔn̺ofos̪faːt̪o	wiki
adenosintrifosfatasi	ad̪en̺os̪in̪t̪r̺ifos̪fat̪aːz̪i	wiki
adenosintrifosfato	äd̪e̞n̺oz̪in̪t̪r̺ifos̪fäːt̪o̞	wiki
adiettivo	äd̪jet̪t̪iːvo	wiki
adinolfi	äd̪in̺ol̺fi	wiki
adinolfo	äd̪in̺ol̺fo	wiki
adiposità	adipozita	wiki
adolfo	äd̪ɔl̺fo	wiki
adontamento	äd̪o̞n̪t̪äme̞n̪t̪o	wiki
adontare	äd̪o̞n̪t̪äːr̺e̞	wiki
adontarsi	äd̪o̞n̪t̪är̺s̪i	wiki
adunche	ad̪uŋk̟e	wiki
aere	äːe̞r̺e	wiki
aerolite	äe̞r̺ɔːl̺it̪e	wiki
aerolito	äe̞r̺ɔːl̺it̪o	wiki
afa	äːfä	wiki
affida	äffiːd̪ä	wiki
affidabile	äffidäːbil̺e	wiki
affidabilità	äffidäbil̺it̪ä	wiki
affidamento	äffid̪äme̞n̪t̪o	wiki
affidare	äffid̪äːr̺e̞	wiki
affidarsi	äffid̪är̺s̪i	wiki
affidatario	äffid̪ät̪äːr̺jo	wiki
affido	äffiːd̪o	wiki
affilato	affilato	wiki
affogare	äffo̞ɡäːr̺e̞	wiki
affreddare	äffr̺e̞d̪d̪äːr̺e̞	wiki
afosità	äfo̞z̪it̪ä	wiki
afoso	äfo̞ːz̪o	wiki
afrikander	äfr̺ikän̪d̪e̞r̺	wiki
afrikaner	äfr̺ikäːn̺e̞r̺	wiki
afrolite	äfr̺o̞l̺iːt̪e	wiki
aggettivale	ädd͡ʒe̞t̪t̪iväːl̺e̞	wiki
aggettivamente	ädd͡ʒe̞t̪t̪iväme̞n̪t̪e	wiki
aggettivare	ädd͡ʒe̞t̪t̪iväːr̺e̞	wiki
aggettivato	ädd͡ʒe̞t̪t̪iväːt̪o̞	wiki
aggettivazione	ädd͡ʒe̞t̪t̪ivät̪t̪͡s̪joːn̺e	wiki
aggettivo	ädd͡ʒe̞t̪t̪iːvo	wiki
agghindare	äɡ̟ːin̪d̪äːr̺e̞	wiki
agghindarsi	äɡ̟ːin̪d̪är̺s̪i	wiki
aggiudicare	ädd͡ʒud̪ikäːr̺e̞	wiki
aggiudicarsi	ädd͡ʒud̪ikär̺s̪i	wiki
aggiudicatario	ädd͡ʒud̪ikät̪äːr̺jo	wiki
aggiudicativo	ädd͡ʒud̪ikät̪iːvo	wiki
aggiudicatore	ädd͡ʒud̪ikät̪o̞ːr̺e	wiki
aggiudicatrice	ädd͡ʒud̪ikät̪r̺iːt͡ʃe	wiki
aggiudicazione	ädd͡ʒud̪ikät̪t̪͡s̪joːn̺e	wiki
aggiustaggio	add͡ʒus̪t̪ädd͡ʒo̞	wiki
aggiustamento	ädd͡ʒus̪t̪äme̞n̪t̪o	wiki
aggiustare	ädd͡ʒus̪t̪äːr̺e̞	wiki
aggiustarsi	add͡ʒus̪t̪är̺s̪i	wiki
aggiustata	add͡ʒus̪t̪äːt̪ä	wiki
aggiustatezza	add͡ʒus̪t̪ät̪e̞t̪t̪͡s̪ä	wiki
aggiustato	add͡ʒus̪t̪äːt̪o̞	wiki
aggiustatore	ädd͡ʒus̪t̪ät̪o̞ːr̺e	wiki
aggiustatrice	ädd͡ʒus̪t̪ät̪r̺iːt͡ʃe	wiki
aggiustatura	ädd͡ʒus̪t̪ät̪uːr̺ä	wiki
aggiusteria	ädd͡ʒus̪t̪er̺iä̯	wiki
aggiustore	ädd͡ʒus̪t̪o̞ːr̺e	wiki
aggregato	äɡɡr̺e̞ɡäːt̪o̞	wiki
agguantare	äɡɡwän̪t̪äːr̺e̞	wiki
agire	äd͡ʒiːr̺e	wiki
agnello	äɲɲɛl̺l̺o	wiki
agnolotto	äɲːolɔt̪ːo	wiki
agnosticismo	äɲːo̞s̪t̪it͡ʃiz̪mo	wiki
agnostico	äɲɲɔs̪t̪iko	wiki
agognare	äɡo̞ɲɲäːr̺e̞	wiki
agonie	aɡonie	wiki
agopuntura	aɡopuntura	wiki
agrigentino	äɡrid͡ʒen̪t̪iːno	wiki
agrippina	äɡripːiːnä	wiki
aiere	äːje̞r̺e	wiki
ailuride	äi̯l̺uːr̺id̪e	wiki
ailuridi	äi̯l̺uːr̺id̪i	wiki
ailuro	äi̯l̺uːr̺o	wiki
aire	äiːr̺e	wiki
aire	äːir̺e	wiki
aiuola	äjwɔːl̺ä	wiki
aiuto	äjuːt̪o	wiki
akragas	äkräːɡäs	wiki
ala	ala	wiki
alabarda	äl̺äbär̺d̪ä	wiki
alalonga	äl̺äl̺ɔŋɡä	wiki
alalunga	äl̺äl̺uŋɡä	wiki
alalà	al̺al̺a	wiki
alarica	äl̺är̺iːkä	wiki
alarico	äl̺är̺iːko	wiki
albacora	äl̺bäkɔːr̺ä	wiki
albagio	äl̺bäːd͡ʒo̞	wiki
albedine	äl̺bɛːd̪in̺e	wiki
alberaggio	äl̺be̞r̺ädd͡ʒo̞	wiki
albereta	äl̺be̞r̺eːt̪ä	wiki
albereto	äl̺be̞r̺eːt̪o	wiki
albergo	äl̺bɛr̺ɡo	wiki
alberto	äl̺bɛr̺t̪o	wiki
albicare	äl̺bikäːr̺e̞	wiki
albicatura	äl̺bikät̪uːr̺ä	wiki
albicore	äl̺bikɔːr̺e	wiki
albo	äl̺bo̞	wiki
alcanna	äl̺kän̺n̺ä	wiki
alcol	äl̺ko̞l̺	wiki
alcuni	alkuni	wiki
alcuno	älkuːn̺o	wiki
aldighiero	äl̺d̪iɡ̟jɛːr̺o	wiki
aldilà	äl̪d̪il̺ä	wiki
alef	äːl̺e̞f	wiki
aleppina	äl̺eppiːn̺ä	wiki
aleppino	äl̺e̞ppiːn̺o	wiki
aleppo	äl̺e̞ppo	wiki
alessandro	al̺es̪s̪an̪d̪r̺o	wiki
alfa	äl̺fä	wiki
alfabeto	älfäbɛːt̪o	wiki
alfeide	äl̺fɛi̯d̪e	wiki
alfiere	alfjɛːre	wiki
algarrobo	äl̺ɡär̺r̺ɔːbo	wiki
algebra	äl̺ʲd͡ʒe̞br̺ä	wiki
algente	äl̺ʲd͡ʒɛn̪t̪e	wiki
algere	äl̺ʲd͡ʒe̞r̺e	wiki
algere	äl̺ʲd͡ʒe̞ːr̺e	wiki
algeria	äl̺ʲd͡ʒe̞r̺iːä	wiki
algherese	älɡ̟ereːse	wiki
algherese	älɡ̟ereːze	wiki
alghero	älɡ̟ɛːro	wiki
algido	äl̺ʲd͡ʒid̪o	wiki
algore	al̺ɡoːr̺e	wiki
alice	äliːt͡ʃe	wiki
alif	äl̺if	wiki
alighieri	äl̺iɡ̟jɛːr̺i	wiki
alighiero	äl̺iɡjɛːr̺o	wiki
alighiero	äl̺iɡ̟jɛːr̺o	wiki
all'uopo	äl̺l̺wɔːpo	wiki
allappare	äl̺ːäppäːr̺e̞	wiki
allarme	äl̺l̺är̺me̞	wiki
allegria	äl̺l̺e̞ɡr̺iːä	wiki
allenare	äl̺l̺e̞n̺äːr̺e̞	wiki
allenarsi	äl̺l̺e̞n̺är̺s̪i	wiki
allineare	äl̺ːin̺eäːr̺e	wiki
allinearsi	äl̺ːin̺eär̺si	wiki
alloplastica	äl̺l̺o̞pl̺äs̪t̪ikä	wiki
alloplastico	äl̺l̺o̞pl̺äs̪t̪iko	wiki
allotta	äl̺l̺ɔt̪ːä	wiki
allumare	äl̺l̺umäːr̺e̞	wiki
alluminio	äl̺ːumiːn̺jo	wiki
altero	äl̺t̪e̞r̺o	wiki
altiero	äl̺t̪jɛːr̺o	wiki
altro	äl̪t̪r̺o	wiki
alveolare	äl̺veol̺äːr̺e	wiki
alveolare	äl̺ve̯ol̺äːr̺e	wiki
alzagola	äl̪t̪͡s̪äːɡo̞l̺ä	wiki
alzavola	äl̪t̪͡s̪äːvo̞l̺ä	wiki
amarena	amarɛna	wiki
amaro	ämäːr̺o̞	wiki
amarone	ämäroːne	wiki
ambaradan	ämbär̺äd̪än̺	wiki
ambascia	ämbäʃʃä	wiki
ambiare	ämbjäːr̺e̞	wiki
ambigenere	ämbid͡ʒɛːn̺er̺e	wiki
ambrenti	ämbr̺e̞n̪t̪i	wiki
ambrogio	ämbrɔːd͡ʒo	wiki
ambrosiano	ämbrozjäːno	wiki
amendue	ämen̪d̪uːe	wiki
americio	ämeriːt͡ʃo	wiki
amiantiero	ämjän̪t̪jɛːr̺o	wiki
amiantite	ämjän̪t̪iːt̪e	wiki
amianto	ämjän̪t̪o̞	wiki
ammaraggio	ämmär̺ädd͡ʒo̞	wiki
ammarare	ämmär̺äːr̺e̞	wiki
ammattire	ämːät̪ːiːre	wiki
ammazzacaffè	ämːät̪͡ːs̪äkäfːɛ	wiki
ammogliare	ämmo̞ʎʎäːr̺e̞	wiki
ammogliarsi	ämmo̞ʎʎär̺s̪i	wiki
amore	ämoːre	wiki
amorfo	ämɔr̺fo	wiki
amostante	ämo̞s̪t̪än̺t̪e̞	wiki
anabena	än̺äbɛːn̺ä	wiki
anacronismo	än̺äkr̺o̞n̺iz̪mo	wiki
anacronisticamente	än̺äkr̺o̞n̺is̪t̪ikäme̞n̪t̪e	wiki
anacronistico	än̺äkr̺o̞n̺is̪t̪iko	wiki
ananas	an̺an̺as̺	wiki
ananas	aːn̺an̺as̺	wiki
ananasso	änanäsːo	wiki
anancasmo	än̺äŋkäz̪mo̞	wiki
anancastico	än̺äŋkäs̪t̪iko	wiki
ananche	än̺äŋke̞	wiki
anapesto	än̺äpɛs̪t̪o	wiki
anapo	än̺äpo̞	wiki
anarchia	änärk̟iːä	wiki
anatema	än̺ät̪ɛːmä	wiki
anca	äŋkä	wiki
anche	äŋke	wiki
anco	äŋko	wiki
ancora	äŋkoːrä	wiki
ancorché	aŋkor̺k̟e	wiki
andazzo	än̪d̪ät̪t̪͡s̪o̞	wiki
andrea	and̪rɛːa	wiki
andreeobri	änd̪r̺e̞eɔbr̺i	wiki
andreeobrio	änd̪r̺e̞eɔːbr̺jo	wiki
androconio	än̪d̪r̺o̞kɔːn̺jo	wiki
androide	än̪d̪r̺ɔi̯d̪e	wiki
anello	än̺ɛl̺l̺o	wiki
anfetamina	äɱfe̞t̪ämiːn̺ä	wiki
anfibio	aɱfiːbi̯o	wiki
angioblastico	än̪ʲd͡ʒo̞bl̺äs̪t̪iko	wiki
anglicizzare	äŋɡlit͡ʃid̪͡ːz̪äːre	wiki
anglicizzarsi	aŋɡlit͡ʃid̪d̪͡z̪ar̺s̪i	wiki
angolo	äŋɡo̞l̺o	wiki
angue	äŋɡwe̞	wiki
anguilla	ãŋɡwil̺ːä	wiki
anguria	äŋɡuːr̺jä	wiki
animella	än̺imɛl̺l̺ä	wiki
anna	än̺n̺ä	wiki
annam	än̺n̺äm	wiki
annamita	än̺n̺ämiːt̪ä	wiki
annamitico	än̺n̺ämiːt̪iko	wiki
annasare	än̺n̺äz̪äːr̺e̞	wiki
annegamento	än̺n̺e̞ɡäme̞n̪t̪o	wiki
annegare	än̺n̺e̞ɡäːr̺e̞	wiki
annegato	än̺n̺e̞ɡäːt̪o̞	wiki
anno	än̺ːo̞	wiki
annusare	än̺n̺uz̪äːr̺e̞	wiki
anodino	än̺ɔːd̪in̺o	wiki
anodo	äːn̺o̞d̪o	wiki
anonimità	anonimita	wiki
anorchismo	än̺o̞r̺kiz̪mo	wiki
anrico	än̺r̺iːko	wiki
ansito	än̪s̪it̪o	wiki
ante	än̪t̪e̞	wiki
anteco	än̪t̪ɛːko	wiki
anti	än̪t̪i	wiki
antiblastico	än̪t̪ibl̺äs̪t̪iko	wiki
antidiluviano	än̪t̪id̪il̺uvjäːn̺o̞	wiki
antifascista	än̪t̪ifäʃʃis̪t̪ä	wiki
antiomega	än̪t̪iomɛːɡä	wiki
antiplastico	än̪t̪ipl̺äs̪t̪iko	wiki
antiscialagogo	än̪t̪iʃʃäl̺äɡɔːɡo	wiki
antitetico	än̪t̪it̪ɛːt̪iko	wiki
antiteto	än̪t̪iːt̪et̪o	wiki
antologia	än̪t̪ol̺od͡ʒiːä	wiki
antonimia	än̪t̪on̺imiːä	wiki
antonimo	an̪t̪ɔːn̺imo	wiki
antonomasia	än̪t̪o̞n̺omäːz̪jä	wiki
antropogenesi	än̪t̪r̺o̞pod͡ʒɛːn̺ez̪i	wiki
antropogenia	än̪t̪r̺o̞pod͡ʒen̺iːä	wiki
anulare	änuläːre	wiki
aonio	äɔːn̺jo	wiki
aosta	äɔst̪ä	wiki
aostano	äost̪äːno	wiki
apartheid	äpär̺t̪äi̯d̪	wiki
ape	apɛ	wiki
apeliota	äpe̞l̺jɔːt̪ä	wiki
apeliote	äpe̞l̺jɔːt̪e	wiki
aperea	äpɛːr̺e̯ä	wiki
apo	äːpo̞	wiki
apoditerio	äpo̞d̪it̪ɛːr̺jo	wiki
apologeta	äpo̞l̺od͡ʒɛːt̪ä	wiki
apologista	äpo̞l̺od͡ʒis̪t̪ä	wiki
aposteriorità	äpo̞s̪t̪er̺jor̺it̪ä	wiki
apostrofo	äpɔs̪t̪r̺ofo	wiki
apotropaico	apo̞t̪r̺opaːi̯ko	wiki
apozema	äpɔːd̪͡z̪emä	wiki
apozzema	äpɔd̪d̪͡z̪emä	wiki
appo	äppo̞	wiki
appodiare	äppo̞d̪jäːr̺e̞	wiki
apporre	äppo̞r̺r̺e	wiki
apposito	äppɔːz̪it̪o	wiki
apposta	äppo̞s̪t̪ä	wiki
apposta	äppɔs̪t̪ä	wiki
appunto	äppun̪t̪o	wiki
aprassia	äpr̺äs̪s̪iä̯	wiki
aprico	äpr̺iːko	wiki
aprile	äpriːl̺e	wiki
aptonastia	äpt̪o̞n̺äs̪t̪iä̯	wiki
aptonastia	äpt̪o̞n̺äs̪t̪iːä	wiki
aptonastico	äpt̪o̞n̺äs̪t̪iko	wiki
aquatico	äkwäːt̪iko	wiki
arachide	äräːk̟id̪e̞	wiki
arancino	är̺än̠ʲt͡ʃiːn̺o	wiki
arbelo	är̺bɛːl̺o	wiki
arbore	är̺bo̞r̺e	wiki
archeozoico	är̺keo̯d̪͡z̪ɔi̯ko	wiki
architrave	är̺k̟it̪r̺äːve̞	wiki
arcigno	är̺t͡ʃiɲɲo	wiki
arcipelago	är̺t͡ʃipɛːl̺äɡo̞	wiki
arcobaleno	är̺ko̞bäl̺e̞ːn̺o	wiki
are	äːr̺e̞	wiki
arengo	är̺e̞ŋɡo	wiki
arente	är̺ɛn̪t̪e	wiki
argenteo	är̺d͡ʒɛn̪t̪eo̯	wiki
argento	ärd͡ʒɛn̪t̪o	wiki
argon	är̺ɡon̺	wiki
argon	är̺ɡɔn̺	wiki
aria	äːr̺jä	wiki
ariballo	är̺ibäl̺l̺o̞	wiki
arido	äːr̺id̪o	wiki
aridocoltura	är̺id̪okol̪t̪uːr̺ä	wiki
aringo	är̺iŋɡo	wiki
aristofane	är̺is̪t̪ɔːfän̺e̞	wiki
aritmetica	är̺it̪mɛːt̪ikä	wiki
aritmia	är̺it̪miːä	wiki
aritmico	är̺it̪miko	wiki
arma	är̺mä	wiki
armaiolo	är̺mäjɔːl̺o	wiki
armare	är̺mäːr̺e̞	wiki
armata	är̺mäːt̪ä	wiki
armatura	är̺mät̪uːr̺ä	wiki
armipotente	är̺mipot̪ɛn̪t̪e	wiki
armisonante	är̺mis̪on̺än̪t̪e̞	wiki
arnoglossa	är̺n̺o̞ɡl̺ɔs̪s̪ä	wiki
aronne	är̺ɔn̺n̺e	wiki
arpa	är̺pä	wiki
arpagone	ärpäɡoːne	wiki
arpe	är̺pe̞	wiki
arpinate	är̺pin̺äːt̪e̞	wiki
arpino	är̺piːn̺o	wiki
arrabbiata	ärːäbːjäːt̪ä	wiki
arrabbiato	ärːäbːjäːt̪o	wiki
arrigo	är̺r̺iːɡo	wiki
arrogante	är̺r̺o̞ɡän̪t̪e̞	wiki
arroge	är̺r̺ɔːd͡ʒe	wiki
arrogere	är̺r̺ɔːd͡ʒer̺e	wiki
arrogi	är̺r̺ɔːd͡ʒi	wiki
arrosticino	är̺r̺o̞s̪t̪it͡ʃiːn̺o	wiki
arruffapopoli	är̺r̺uffäpɔːpol̺i	wiki
arruffapopolo	är̺r̺uffäpɔːpol̺o	wiki
arsione	är̺s̪joːn̺e	wiki
arte	är̺t̪e̞	wiki
artificio	är̺t̪ifiːt͡ʃo	wiki
artifizio	är̺t̪ifit̪t̪͡s̪jo	wiki
artigiano	är̺t̪id͡ʒäːn̺o̞	wiki
arzagola	är̺t̪͡s̪äːɡo̞l̺ä	wiki
arzavola	är̺t̪͡s̪äːvo̞l̺ä	wiki
asaro	äːz̪är̺o̞	wiki
asbergo	äz̪bɛr̺ɡo	wiki
asceta	äʃʃɛːt̪ä	wiki
asceterio	äʃʃe̞t̪ɛːr̺jo	wiki
asciolvere	äʃʃɔl̺ver̺e	wiki
asciugabiancheria	äʃʃuɡäbjäŋke̞r̺iːä	wiki
asciugamano	äʃʃuɡämäːn̺o̞	wiki
asciutto	aʃʃutto	wiki
ascolta	äs̪ko̞l̪t̪ä	wiki
aseità	äs̪e̞it̪ä	wiki
asemplo	äz̪ɛmpl̺o	wiki
asempro	äz̪ɛmpr̺o	wiki
asia	aːzi̯a	wiki
asiago	äz̪jäːɡo̞	wiki
aspergine	äs̪pɛr̺d͡ʒin̺e	wiki
aspirantato	äs̪pir̺än̪t̪äːt̪o̞	wiki
aspirante	äs̪pir̺än̪t̪e̞	wiki
aspirazione	äs̪pir̺ät̪t̪͡s̪joːn̺e	wiki
aspro	äs̪pr̺o̞	wiki
assassino	äs̪s̪äs̪s̪iːn̺o	wiki
assecondare	as̪s̪ekon̪d̪aːr̺e	wiki
assediamento	äs̪s̪e̞d̪jäme̞n̪t̪o	wiki
assediante	äs̪s̪e̞d̪jän̪t̪e̞	wiki
assediare	äs̪s̪e̞d̪jäːr̺e̞	wiki
assediato	äs̪s̪e̞d̪jäːt̪o̞	wiki
assediatore	äs̪s̪e̞d̪jät̪o̞ːr̺e	wiki
assedio	äs̪s̪ɛːd̪jo	wiki
asseguire	äs̪s̪e̞ɡwiːr̺e	wiki
assemblabile	äs̪ːe̞mbl̺äːbil̺e	wiki
assemblaggio	äs̪ːe̞mbl̺äd͡ːʒo̞	wiki
assemblare	äs̪s̪e̞mbl̺äːr̺e̞	wiki
assemplo	äs̪s̪ɛmpl̺o	wiki
assempro	äs̪s̪ɛmpr̺o	wiki
assessina	äs̪s̪e̞s̪s̪iːn̺ä	wiki
assessino	äs̪ːe̞s̪ːiːn̺o	wiki
assiolo	äs̪s̪iɔːl̺o	wiki
assiolo	äs̪s̪jɔːl̺o	wiki
assolversi	äs̪s̪ɔl̺ver̺s̪i	wiki
astro	äs̪t̪r̺o̞	wiki
astrobussola	äs̪t̪r̺o̞bus̪s̪ol̺ä	wiki
atarassia	ät̪är̺äs̪s̪iːä	wiki
atarassico	ät̪är̺äs̪ːiko	wiki
atlante	ät̪l̺än̪t̪e̞	wiki
atollo	ät̪ɔl̺ːo	wiki
attediare	ät̪t̪e̞d̪jäːr̺e̞	wiki
attediarsi	ät̪t̪e̞d̪jär̺s̪i	wiki
attendibilità	ät̪t̪e̞n̪d̪ibil̺it̪ä	wiki
attentare	ät̪t̪en̪t̪äːr̺e̞	wiki
attentarsi	ät̪t̪en̪t̪är̺s̪i	wiki
attentato	ät̪t̪en̪t̪äːt̪o̞	wiki
attentatore	ät̪t̪en̪t̪ät̪oːr̺e	wiki
attitudine	ät̪t̪it̪uːd̪in̺e	wiki
attore	ät̪t̪o̞ːr̺e	wiki
attosecondo	ät̪ːo̞s̪ekon̪d̪o	wiki
attrappare	ät̪t̪r̺äppäːr̺e̞	wiki
attrapparsi	ät̪t̪r̺äppär̺s̪i	wiki
attroncare	ät̪t̪r̺o̞ŋkäːr̺e̞	wiki
attuale	ät̪t̪wäːl̺e̞	wiki
attualità	ät̪t̪wäl̺it̪ä	wiki
audience	ɔːd̪jen̪s̪	wiki
auge	äu̯d͡ʒe	wiki
augello	äu̯d͡ʒɛl̺l̺o	wiki
auledo	äu̯l̺ɛːd̪o	wiki
aulente	äu̯l̺ɛn̪t̪e	wiki
aulentissimo	äu̯l̺en̪t̪is̪s̪imo	wiki
aulire	äu̯l̺iːr̺e	wiki
aulore	äu̯l̺oːr̺e	wiki
auloroso	äu̯l̺or̺oːz̪o	wiki
aureo	äu̯r̺eo	wiki
aureo	äu̯r̺e̯o	wiki
aurignaciano	äu̯r̺iɲɲät͡ʃäːn̺o̞	wiki
aurignaziano	äu̯r̺iɲɲät̪t̪͡s̪jäːn̺o̞	wiki
aurora	äu̯r̺ɔːr̺ä	wiki
ausilio	äu̯z̪iːl̺jo	wiki
autarchia	äu̯t̪är̺k̟iːä	wiki
auto	äu̯t̪o	wiki
autoabbronzante	äu̯t̪o̯äbbr̺o̞n̪d̪͡z̪än̪t̪e̞	wiki
autoabbronzatura	äu̯t̪o̯äbbr̺o̞n̪d̪͡z̪ät̪uːr̺ä	wiki
autoaccelerazione	äu̯t̪o̯ätt͡ʃe̞l̺er̺ät̪t̪͡s̪joːn̺e	wiki
autoaccensione	äu̯t̪o̯ätt͡ʃe̞n̪s̪joːn̺e	wiki
autoaccessorio	äu̯t̪o̯ätt͡ʃes̪s̪ɔːr̺jo	wiki
autoaccusa	äu̯t̪o̯äkkuːz̪ä	wiki
autoaccusarsi	äu̯t̪o̯äkkuz̪är̺s̪i	wiki
autoadattante	äu̯t̪o̯äd̪ät̪t̪än̪t̪e	wiki
autoadescante	äu̯t̪o̯äd̪e̞s̪kän̪t̪e	wiki
autoadesivo	äu̯t̪o̯äd̪e̞z̪iːvo	wiki
autoaffermazione	äu̯t̪o̯äffe̞r̺mät̪t̪͡s̪joːn̺e	wiki
autoaffondamento	äu̯t̪o̯äffo̞n̪d̪äme̞n̪t̪o	wiki
autoaffondarsi	äu̯t̪o̯äffo̞n̪d̪är̺s̪i	wiki
autoaggiornamento	äu̯t̪o̯ädd͡ʒo̞r̺n̺äme̞n̪t̪o	wiki
autoaggiunto	äu̯t̪o̯ädd͡ʒun̪t̪o	wiki
autoaggressivo	äu̯t̪o̯äɡɡr̺e̞s̪s̪iːvo	wiki
autoaiuto	äu̯t̪o̯äjuːt̪o	wiki
autoalienazione	äu̯t̪o̯äl̺jen̺ät̪t̪͡s̪joːn̺e	wiki
autoalimentarsi	äu̯t̪o̯äl̺imen̪t̪är̺s̪i	wiki
autoallergia	äu̯t̪o̯äl̺l̺e̞r̺d͡ʒiːä	wiki
autoambulanza	äu̯t̪o̯ämbul̺än̪t̪͡s̪ä	wiki
autoanalisi	äu̯t̪o̯än̺äːl̺iz̪i	wiki
autoanticorpo	äu̯t̪o̯än̪t̪ikɔr̺po	wiki
autoantigene	äu̯t̪o̯än̪t̪iːd͡ʒen̺e	wiki
autoapprendimento	äu̯t̪o̯äppr̺e̞n̪d̪imen̪t̪o	wiki
autoapprovvigionamento	äu̯t̪o̯äppr̺o̞vvid͡ʒon̺äme̞n̪t̪o	wiki
autoarticolato	äu̯t̪o̯är̺t̪ikol̺äːt̪o̞	wiki
autoassoluzione	äu̯t̪o̯äs̪s̪o̞l̺ut̪t̪͡s̪joːn̺e	wiki
autoassolversi	äu̯t̪o̯äs̪s̪ɔl̺ver̺s̪i	wiki
autobetoniera	äu̯t̪obet̪onjɛːr̺ä	wiki
autobiblioteca	äu̯t̪obibl̺jot̪ɛːkä	wiki
autobilanciato	äu̯t̪obil̺än̺ʲt͡ʃäːt̪o̞	wiki
autobiografismo	äu̯t̪objoɡr̺äfiz̪mo	wiki
autobiografo	äu̯t̪objɔːɡr̺äfo̞	wiki
autoblinda	äu̯t̪obl̺in̪d̪ä	wiki
autoblindato	äu̯t̪obl̺in̪d̪äːt̪o̞	wiki
autoblindomitragliatrice	äu̯t̪obl̺in̪d̪omit̪r̺äʎʎät̪r̺iːt͡ʃe	wiki
autobloccante	äu̯t̪obl̺okkän̪t̪e̞	wiki
autobomba	äu̯t̪obombä	wiki
autobotte	äu̯t̪obot̪t̪e	wiki
autobruco	äu̯t̪obr̺uːko	wiki
autocalmiere	äu̯t̪okäl̺mjɛːr̺e	wiki
autocalunnia	äu̯t̪okäl̺un̺n̺jä	wiki
autocamionale	äu̯t̪okämjon̺äːl̺e̞	wiki
autocampeggio	äu̯t̪okämpedd͡ʒo	wiki
autocampionatore	äu̯t̪okämpjon̺ät̪o̞ːr̺e	wiki
autocancellazione	äu̯t̪okän̺ʲt͡ʃe̞l̺l̺ät̪t̪͡s̪joːn̺e	wiki
autocaravan	äu̯t̪okäːr̺ävän̺	wiki
autocaricamento	äu̯t̪okär̺ikäme̞n̪t̪o	wiki
autocaricatura	äu̯t̪okär̺ikät̪uːr̺ä	wiki
autocasa	äu̯t̪okäːz̪ä	wiki
autocatalisi	äu̯t̪okät̪äːl̺iz̪i	wiki
autocateterismo	äu̯t̪okät̪e̞t̪er̺iz̪mo	wiki
autocelebrativo	äu̯t̪ot͡ʃel̺ebr̺ät̪iːvo	wiki
autocensura	äu̯t̪ot͡ʃen̪s̪uːr̺ä	wiki
autocentrante	äu̯t̪ot͡ʃen̪t̪r̺än̪t̪e̞	wiki
autocentro	äu̯t̪ot͡ʃɛn̪t̪r̺o	wiki
autocercante	äu̯t̪ot͡ʃer̺kän̪t̪e̞	wiki
autocertificare	äu̯t̪ot͡ʃer̺t̪ifikäːr̺e̞	wiki
autocertificativo	äu̯t̪ot͡ʃer̺t̪ifikät̪iːvo	wiki
autocertificato	äu̯t̪ot͡ʃer̺t̪ifikäːt̪o̞	wiki
autocertificazione	äu̯t̪ot͡ʃer̺t̪ifikät̪t̪͡s̪joːn̺e	wiki
autocestello	äu̯t̪ot͡ʃes̪t̪ɛl̺l̺o	wiki
autochiusura	äu̯t̪ok̟juz̪uːr̺ä	wiki
autocinema	äu̯t̪ot͡ʃiːn̺emä	wiki
autocingolato	äu̯t̪ot͡ʃiŋɡol̺äːt̪o̞	wiki
autocisterna	äu̯t̪ot͡ʃis̪t̪ɛr̺nä	wiki
autocitarsi	äu̯t̪ot͡ʃit̪är̺s̪i	wiki
autocitazione	äu̯t̪ot͡ʃit̪ät̪t̪͡s̪joːn̺e	wiki
autocivetta	äu̯t̪ot͡ʃivet̪t̪ä	wiki
autoclastico	äu̯t̪okl̺äs̪t̪iko	wiki
autocolonna	äu̯t̪okol̺on̺n̺ä	wiki
autocombustione	äu̯t̪okombus̪t̪joːn̺e	wiki
autocommento	äu̯t̪okommen̪t̪o	wiki
autocommiserarsi	äu̯t̪okommiz̪er̺är̺s̪i	wiki
autocommiserazione	äu̯t̪okommiz̪er̺ät̪t̪͡s̪joːn̺e	wiki
autocommutatore	äu̯t̪okommut̪ät̪o̞ːr̺e	wiki
autocompattatore	äu̯t̪okompät̪t̪ät̪o̞ːr̺e	wiki
autocompiacimento	äu̯t̪okompjät͡ʃimen̪t̪o	wiki
autoconcessionaria	äu̯t̪okon̺ʲt͡ʃes̪s̪jon̺äːr̺jä	wiki
autoconcessionario	äu̯t̪okon̺ʲt͡ʃes̪s̪jon̺äːr̺jo	wiki
autocondanna	äu̯t̪okon̪d̪än̺n̺ä	wiki
autoconoscenza	äu̯t̪okon̺oʃʃɛn̪t̪͡s̪ä	wiki
autoconsapevolezza	äu̯t̪okon̪s̪äpe̞vol̺et̪t̪͡s̪ä	wiki
autoconservazione	äu̯t̪okon̪s̪er̺vät̪t̪͡s̪joːn̺e	wiki
autoconsistente	äu̯t̪okon̪s̪is̪t̪ɛn̪t̪e	wiki
autoconsistenza	äu̯t̪okon̪s̪is̪t̪ɛn̪t̪͡s̪ä	wiki
autoconsumo	äu̯t̪okon̪s̪uːmo	wiki
autocontrarre	au̯t̪okon̪t̪r̺är̺r̺e̞	wiki
autocontrarsi	au̯t̪okon̪t̪r̺ar̺s̪i	wiki
autocontratto	äu̯t̪okon̪t̪r̺ät̪t̪o̞	wiki
autocontrollo	äu̯t̪okon̪t̪r̺ɔl̺l̺o	wiki
autoconvincersi	äu̯t̪okoɱvin̺ʲt͡ʃer̺s̪i	wiki
autoconvincimento	äu̯t̪okoɱvin̺ʲt͡ʃimen̪t̪o	wiki
autoconvoglio	äu̯t̪okoɱvɔʎʎo	wiki
autocopiante	äu̯t̪okopjän̪t̪e̞	wiki
autocorrelare	äu̯t̪okor̺r̺el̺äːr̺e̞	wiki
autocorrelazione	äu̯t̪okor̺r̺el̺ät̪t̪͡s̪joːn̺e	wiki
autocorrezione	äu̯t̪okor̺r̺et̪t̪͡s̪joːn̺e	wiki
autocorriera	äu̯t̪okor̺r̺jɛːr̺ä	wiki
autocosciente	äu̯t̪okoʃʃɛn̪t̪e	wiki
autocoscienza	äu̯t̪okoʃʃɛn̪t̪͡s̪ä	wiki
autocritica	äu̯t̪okr̺iːt̪ikä	wiki
autocritico	äu̯t̪okr̺iːt̪iko	wiki
autocross	äu̯t̪okr̺ɔs̪	wiki
autocura	äu̯t̪okuːr̺ä	wiki
autodafé	äu̯t̪od̪äfe̞	wiki
autodecisione	äu̯t̪od̪et͡ʃiz̪joːn̺e	wiki
autodefinizione	äu̯t̪od̪efin̺it̪t̪͡s̪joːn̺e	wiki
autodemolitore	äu̯t̪od̪emol̺it̪oːr̺e	wiki
autodemolizione	äu̯t̪od̪emol̺it̪t̪͡s̪joːn̺e	wiki
autodenuncia	äu̯t̪od̪en̺un̺ʲt͡ʃä	wiki
autodenunciarsi	äu̯t̪od̪en̺un̺ʲt͡ʃär̺s̪i	wiki
autodeterminato	äu̯t̪od̪et̪er̺min̺äːt̪o̞	wiki
autodeterminazione	äu̯t̪od̪et̪er̺min̺ät̪t̪͡s̪joːn̺e	wiki
autodiagnosi	äu̯t̪od̪jäɲɲoz̪i	wiki
autodiagnostica	äu̯t̪od̪jäɲɲɔs̪t̪ikä	wiki
autodichiarare	äu̯t̪od̪ik̟jär̺äːr̺e̞	wiki
autodichiararsi	äu̯t̪od̪ik̟jär̺ärsi	wiki
autodichiarato	äu̯t̪od̪ik̟jär̺äːt̪o̞	wiki
autodichiarazione	äu̯t̪od̪ik̟jär̺ät̪t̪͡s̪joːn̺e	wiki
autodidatta	äu̯t̪od̪id̪ät̪t̪ä	wiki
autodidattico	äu̯t̪od̪id̪ät̪t̪iko	wiki
autodidattismo	äu̯t̪od̪id̪ät̪t̪iz̪mo	wiki
autodifesa	äu̯t̪od̪ifeːz̪ä	wiki
autodigestione	äu̯t̪od̪id͡ʒes̪t̪joːn̺e	wiki
autodina	äu̯t̪od̪iːn̺ä	wiki
autodirezionale	äu̯t̪od̪ir̺et̪t̪͡s̪jon̺äːl̺e̞	wiki
autodistribuito	äu̯t̪od̪is̪t̪r̺ibwiːt̪o	wiki
autodistruggersi	äu̯t̪od̪is̪t̪r̺udd͡ʒer̺s̪i	wiki
autodonazione	äu̯t̪od̪on̺ät̪t̪͡s̪joːn̺e	wiki
autoeccitante	äu̯t̪o̯ett͡ʃit̪än̪t̪e̞	wiki
autoeccitarsi	äu̯t̪o̯ett͡ʃit̪är̺s̪i	wiki
autoeccitazione	äu̯t̪o̯ett͡ʃit̪ät̪t̪͡s̪joːn̺e	wiki
autoecologia	äu̯t̪o̯ekol̺od͡ʒiːä	wiki
autoeditore	äu̯t̪o̯ed̪it̪oːr̺e	wiki
autoeditoria	äu̯t̪o̯ed̪it̪or̺iːä	wiki
autoeducazione	äu̯t̪o̯ed̪ukät̪t̪͡s̪joːn̺e	wiki
autoefficacia	äu̯t̪o̯effikäːt͡ʃä	wiki
autoemarginazione	äu̯t̪o̯emär̺d͡ʒin̺ät̪t̪͡s̪joːn̺e	wiki
autoemoteca	äu̯t̪o̯emot̪ɛːkä	wiki
autoemoterapia	äu̯t̪o̯emot̪er̺äpiːä	wiki
autoemotrasfusione	äu̯t̪o̯emot̪r̺äs̪fuz̪joːn̺e	wiki
autoerotico	äu̯t̪o̯er̺ɔːt̪iko	wiki
autoerotismo	äu̯t̪o̯er̺ot̪iz̪mo	wiki
autoesaltazione	äu̯t̪o̯ez̪äl̪t̪ät̪t̪͡s̪joːn̺e	wiki
autoesame	äu̯t̪o̯ez̪äːme̞	wiki
autoescludersi	äu̯t̪o̯es̪kl̺uːd̪er̺s̪i	wiki
autoestinguente	äu̯t̪o̯es̪t̪iŋɡwɛn̪t̪e	wiki
autoeterodina	äu̯t̪o̯et̪er̺od̪iːn̺ä	wiki
autofagocitosi	äu̯t̪ofäɡo̞t͡ʃit̪ɔːz̪i	wiki
autofagosoma	äu̯t̪ofäɡo̞s̪ɔːmä	wiki
autofattura	äu̯t̪ofät̪t̪uːr̺ä	wiki
autofecondazione	äu̯t̪ofekon̪d̪ät̪t̪͡s̪joːn̺e	wiki
autoferrotranviario	äu̯t̪ofɛr̺r̺ot̪r̺äɱvjäːr̺jo	wiki
autoferrotranviere	äu̯t̪ofɛr̺r̺ot̪r̺äɱvjɛːr̺e	wiki
autofertile	äu̯t̪ofɛr̺t̪il̺e	wiki
autofertilizzante	äu̯t̪ofer̺t̪il̺id̪d̪͡z̪än̪t̪e̞	wiki
autofficina	äu̯t̪offit͡ʃiːn̺ä	wiki
autofilettante	äu̯t̪ofil̺et̪t̪än̪t̪e̞	wiki
autofilotranviario	äu̯t̪ofil̺ot̪r̺äɱvjäːr̺jo	wiki
autofinanziamento	äu̯t̪ofin̺än̪t̪͡s̪jäme̞n̪t̪o	wiki
autofinanziarsi	äu̯t̪ofin̺än̪t̪͡s̪jär̺s̪i	wiki
autoflagellazione	äu̯t̪ofl̺äd͡ʒe̞l̺l̺ät̪t̪͡s̪joːn̺e	wiki
autofocus	äu̯t̪ofɔːkus̪	wiki
autointrospezione	äu̯t̪o̯in̪t̪r̺os̪pet̪t̪͡s̪joːn̺e	wiki
autoistoradiografia	äu̯t̪ois̪t̪or̺äd̪joɡr̺äfiːä	wiki
automobile	au̯t̪omɔːbile	wiki
autoplastica	äu̯t̪opl̺äs̪t̪ikä	wiki
autoplastico	äu̯t̪opl̺äs̪t̪iko	wiki
autorità	äu̯t̪or̺it̪ä	wiki
autoschediastico	äu̯t̪os̪ked̪jäs̪t̪iko	wiki
autunno	äu̯t̪un̺n̺o	wiki
avaccio	ävätt͡ʃo̞	wiki
avante	ävän̪t̪e	wiki
avanti	ävän̪t̪i	wiki
avemaria	äve̞mär̺iä̯	wiki
avemmo	avemmo	wiki
aventiniano	äve̞n̪t̪in̺jäːn̺o̞	wiki
aventino	äve̞n̪t̪iːn̺o	wiki
avere	äveːr̺e	wiki
aveste	aves̪t̪e	wiki
avesti	aves̪t̪i	wiki
avete	aveːt̪e	wiki
aveva	aveːvo	wiki
avevi	aveːvi	wiki
avevo	aveːvo	wiki
avicennia	ävit͡ʃɛn̺n̺jä	wiki
avicenniano	ävit͡ʃen̺n̺jäːn̺o̞	wiki
avicennismo	ävit͡ʃen̺n̺iz̪mo̞	wiki
avicennista	ävit͡ʃen̺n̺is̪t̪ä	wiki
aviotrasportare	ävjot̪r̺äs̪po̞r̺t̪är̺e̞	wiki
aviotruppa	ävjot̪r̺uppä	wiki
avocare	ävo̞käːr̺e̞	wiki
avocatorio	ävo̞kät̪ɔːr̺jo	wiki
avvelenare	avvel̺en̺aːr̺e̞	wiki
avvento	avvɛnto	wiki
avverbio	ävvɛr̺bjo	wiki
avvinazzare	avːin̺ät̪͡ːs̪äːr̺e̞	wiki
avvinazzarsi	ävvin̺ät̪͡ːs̪är̺s̪i	wiki
avvocatizio	ävːokät̪it̪͡ːs̪jo	wiki
avvocato	ävvokäːt̪o	wiki
avvoltare	ävvo̞l̪t̪äːr̺e̞	wiki
azara	äd̪͡z̪äːr̺ä	wiki
azienda	äd̪͡z̪jɛn̪d̪ä	wiki
azimut	äd̪͡z̪imut̪	wiki
azoto	äd̪͡z̪ːɔːt̪o	wiki
azteco	äs̪t̪ɛːko	wiki
azzara	äd̪͡z̪d̪͡z̪äːr̺ä	wiki
azzardo	äd̪d̪͡z̪är̺d̪o̞	wiki
babbana	bäbːäːnä	wiki
babbano	bäbːäːno	wiki
babbo	bäbbo̞	wiki
babilonia	bäbil̺ɔːn̺jä	wiki
babla	bäːblä	wiki
baccello	bät͡ːʃɛl̺l̺o	wiki
bacchiare	bäkkjäːr̺e̞	wiki
bacchio	bäkkjo	wiki
baccifero	bätt͡ʃiːfer̺o	wiki
baciapile	bät͡ʃäpiːl̺e	wiki
bacillosi	bät͡ʃil̺l̺ɔːz̪i	wiki
bacino	bät͡ʃiːn̺o	wiki
bacio	bäːt͡ʃo̞	wiki
bacolo	bäːko̞l̺o	wiki
bagala	bäːɡäl̺ä	wiki
baggala	bäɡɡäl̺ä	wiki
baggiana	bädd͡ʒäːn̺ä	wiki
bagnomaria	bäɲːomär̺iːä	wiki
balandra	bälän̪d̪rä	wiki
balbare	bäl̺bäːr̺e̞	wiki
balbo	bäl̺bo̞	wiki
balco	bäl̺ko̞	wiki
balcone	bäl̺ko̞ːn̺e	wiki
baldovino	baldovino	wiki
balenare	bäl̺e̞n̺äːr̺e̞	wiki
baleno	bäl̺e̞ːn̺o	wiki
balordo	bäl̺o̞r̺d̪o	wiki
bambino	bämbiːn̺o	wiki
bambo	bämbo̞	wiki
banca	bäŋkä	wiki
barabba	bär̺äbbä	wiki
barbagliare	bär̺bäʎʎäːr̺e̞	wiki
barbaresco	bärbäresko	wiki
barbascia	bär̺bäʃʃä	wiki
barberia	bär̺be̞r̺iä̯	wiki
barbiere	bar̺bi̯ɛːr̺e̞	wiki
barbieria	bär̺bje̞r̺iä̯	wiki
bardito	bär̺d̪iːt̪o	wiki
bardo	bär̺d̪o̞	wiki
barena	bär̺eːn̺a	wiki
barena	bär̺ɛːn̺a	wiki
bareno	bär̺ɛːn̺o	wiki
barolo	bärɔːlo	wiki
barometro	barometro	wiki
basilico	bäz̪iːl̺iko	wiki
bassacorte	bäs̪s̪äkor̺t̪e	wiki
bassarisco	bäs̪s̪är̺is̪ko	wiki
bastagio	bäs̪t̪äːd͡ʒo̞	wiki
bastaso	bäs̪t̪äːz̪o̞	wiki
bastone	bastone	wiki
batacchio	bät̪äkkjo	wiki
batticarne	bät̪ːikär̺n̺e	wiki
battilocchio	bät̪t̪il̺ɔkk̟jo	wiki
battiloglia	bät̪t̪il̺ɔʎʎä	wiki
battiloglio	bät̪t̪il̺ɔʎʎo	wiki
battola	bät̪t̪o̞l̺ä	wiki
beatore	beä̯t̪o̞ːr̺e	wiki
beatrice	beä̯t̪r̺iːt͡ʃe	wiki
befana	befäːnä	wiki
belgio	bɛl̺ʲd͡ʒo	wiki
bellimbusto	bel̺ːimbus̪t̪o	wiki
bellinzona	bel̺ːin̪t̪͡s̪oːnä	wiki
belluria	bel̺l̺uːr̺jä	wiki
belo	bɛːl̺o	wiki
beltade	bel̪t̪äːd̪e̞	wiki
beltate	bel̪t̪äːt̪e̞	wiki
beltà	bel̪t̪ä	wiki
bene	beːne	wiki
bene	bɛːne	wiki
benedicite	ben̺ed̪iːt͡ʃit̪e̞	wiki
bengodi	beŋɡɔːd̪i	wiki
benvenuto	beɱven̺uːt̪o	wiki
benzene	ben̪d̪͡z̪ɛːn̺e	wiki
beppe	bɛppe	wiki
bequadro	bekwäːd̪r̺o̞	wiki
berardo	ber̺är̺d̪o̞	wiki
berberide	ber̺bɛːr̺id̪e	wiki
berciare	ber̺t͡ʃäːr̺e̞	wiki
bere	beːr̺e	wiki
berillio	ber̺il̺ːjo	wiki
berlusconi	berluskoːni	wiki
bernarda	ber̺n̺är̺d̪ä	wiki
bernardi	ber̺n̺är̺d̪i	wiki
bernardina	ber̺n̺är̺d̪iːn̺ä	wiki
bernardino	ber̺n̺är̺d̪iːn̺o	wiki
bernardo	ber̺n̺är̺d̪o̞	wiki
bersagliare	ber̺s̪äʎʎäːr̺e̞	wiki
bersaglio	ber̺s̪äʎʎo̞	wiki
berto	bɛr̺t̪o	wiki
besciamella	beʃːämɛl̺ːä	wiki
bessera	bes̪s̪ɛːr̺ä	wiki
bestemmia	bes̪t̪emmjä	wiki
bestemmiare	bes̪t̪emmjäːr̺e̞	wiki
bestemmiona	bes̪t̪emmjoːn̺ä	wiki
bestemmione	bes̪t̪emmjoːn̺e	wiki
bet	bɛt̪	wiki
beta	bɛːt̪ä	wiki
betacismo	bet̪ät͡ʃiz̪mo	wiki
betlemita	bet̪l̺emiːt̪ä	wiki
betlemme	bet̪l̺ɛmme	wiki
bevere	beːver̺e	wiki
biacca	bjäkːä	wiki
bianca	bjäŋkä	wiki
biancheggiante	bjäŋke̞dd͡ʒän̪t̪e̞	wiki
biancicante	bjän̺ʲt͡ʃikän̪t̪e̞	wiki
biancicare	bjän̺ʲt͡ʃikäːr̺e̞	wiki
biascia	bjäʃʃä	wiki
biasciare	bjäʃʃäːr̺e̞	wiki
biascicare	bjäʃʃikäːr̺e̞	wiki
bicicletta	bit͡ʃikl̺et̪t̪a	wiki
biciclettata	bit͡ʃikl̺et̪t̪aːt̪a	wiki
bieltate	bjel̪t̪äːt̪e̞	wiki
bienne	biɛn̺n̺e	wiki
bieta	bjɛːt̪ä	wiki
bietola	bjɛːt̪ol̺ä	wiki
bietta	bjet̪ːä	wiki
bifolcheria	bifol̺ker̺iä̯	wiki
bifolco	bifol̺ko	wiki
bigio	biːd͡ʒo	wiki
biglietto	biʎʎet̪t̪o	wiki
bilabiale	bil̺äbjäːl̺e̞	wiki
biliardaia	bil̺jär̺d̪äːjä	wiki
biliardaio	bil̺jär̺d̪äːjo	wiki
biltade	bil̪t̪äːd̪e̞	wiki
biltate	bil̪t̪äːt̪e̞	wiki
biltà	bil̪t̪ä	wiki
bino	biːn̺o	wiki
biodo	bjoːd̪o	wiki
biodo	bjɔːd̪o	wiki
bioregione	bior̺ed͡ʒoːn̺e	wiki
birmania	bir̺mäːn̺jä	wiki
bisarcavolo	biz̪är̺käːvo̞l̺o	wiki
bisbetico	biz̪bɛːt̪iko	wiki
bisbigliare	biz̪biʎʎäːr̺e̞	wiki
biscotto	biskɔt̪ːo	wiki
bisdrucciolo	biz̪d̪r̺utt͡ʃol̺o	wiki
bistentare	bis̪t̪en̪t̪äːr̺e̞	wiki
bistento	bis̪t̪ɛn̪t̪o	wiki
bistondo	bis̪t̪on̪d̪o	wiki
bisturi	bis̪t̪ur̺i	wiki
biunivocità	biun̺iːvot͡ʃit̪ä	wiki
biunivoco	biun̺iːvoko	wiki
bizzeffe	bid̪͡ːz̪ɛfːe	wiki
blasfemare	bl̺as̪fe̞mäːr̺e̞	wiki
blatta	bl̺at̪t̪a	wiki
blesbok	bl̺ɛz̪bok	wiki
blinda	bl̺in̪d̪ä	wiki
bloccaggio	bl̺okkäd̪d͡ʒo̞	wiki
blu	blu	wiki
bluetooth	blut̪ut̪ː	wiki
boario	boäːr̺jo	wiki
boaro	boväːr̺o	wiki
bocchino	bokk̟iːn̺o	wiki
bocco	bɔkko	wiki
bocconiana	bokːonjäːnä	wiki
bocconiano	bokːonjäːno	wiki
bohrio	bɔːhr̺jo	wiki
bonango	bon̺äŋɡo̞	wiki
bonifacina	bon̺ifät͡ʃiːn̺ä	wiki
bonifacino	bon̺ifät͡ʃiːn̺o	wiki
bonifacio	bon̺ifäːt͡ʃo	wiki
bonifazio	bon̺ifät͡ːsjo	wiki
bonto	bɔn̪t̪o	wiki
boragine	bor̺äːdʒin̺e	wiki
borghesia	bor̺ɡez̪iːä	wiki
borio	bɔːr̺jo	wiki
boro	bɔːr̺o	wiki
borragine	bor̺r̺äːdʒin̺e	wiki
bosega	boːz̪eɡä	wiki
botta	bɔtta	wiki
bottegaio	bot̪t̪eɡäːjo̞	wiki
botticella	bot̪t̪it͡ʃɛl̺l̺ä	wiki
bovaro	boväːr̺o	wiki
boyscout	boi̯s̪käu̯t̪	wiki
braccino	br̺ätt͡ʃiːn̺o	wiki
braccino	br̺ät͡ːʃin̺o	wiki
braccio	br̺att͡ʃo	wiki
bracciolo	br̺att͡ʃɔːl̺o	wiki
brace	br̺äːt͡ʃe̞	wiki
branca	br̺äŋkä	wiki
brecco	br̺ekko	wiki
brenna	br̺en̺n̺ä	wiki
briccola	br̺ikːol̺ä	wiki
bricconcella	br̺ikkon̺ʲt͡ʃɛl̺l̺ä	wiki
bricconcello	br̺ikːon̺ʲt͡ʃɛl̺ːo	wiki
briccone	br̺ikkoːn̺e	wiki
briefing	br̺iːfiŋɡ	wiki
briscola	briskola	wiki
brividante	br̺ivid̪än̺t̪e̞	wiki
brividio	br̺ivid̪iːo	wiki
brivido	br̺iːvid̪o	wiki
brividoso	br̺ivid̪oːz̪o	wiki
brocca	br̺ɔkkä	wiki
broccoli	brɔk̚koli	wiki
broccolo	brɔk̚kolo	wiki
bronzo	br̺on̪d̪͡z̪o	wiki
bruciacchiare	br̺ut͡ʃäkk̟jäːr̺e̞	wiki
bruciacchiarsi	br̺ut͡ʃäkk̟jär̺s̪i	wiki
bruciacchiatura	br̺ut͡ʃäkk̟jät̪uːr̺ä	wiki
brunelda	br̺un̺el̪d̪ä	wiki
brunilda	br̺un̺il̪d̪ä	wiki
brunilde	br̺un̺il̪d̪e	wiki
brunildo	br̺un̺il̪d̪o	wiki
bruschetta	br̺us̪ket̪ːä	wiki
brussellese	brusːelːeːse	wiki
brussellese	brusːelːeːze	wiki
bucazio	bukät̪t̪͡s̪jo	wiki
budda	bud̪d̪ä	wiki
bugia	bud͡ʒiːä	wiki
bugia	buːd͡ʒä	wiki
bugiardamente	bud͡ʒar̺d̪amen̪t̪e	wiki
bugiardino	bud͡ʒar̺d̺iːn̺o	wiki
bugio	buːd͡ʒo	wiki
buna	buːn̺ä	wiki
buoi	bwɔi̯	wiki
buonamente	bwon̺äme̞n̪t̪e	wiki
buone	bwɔːne	wiki
burnus	bur̺n̺us̪	wiki
burrata	burːäːt̪ä	wiki
burro	burro	wiki
bussola	bus̪s̪ol̺ä	wiki
busto	bus̪t̪o	wiki
buzzurra	bud̪d̪͡z̪ur̺r̺ä	wiki
buzzurro	bud̪d̪͡z̪ur̺r̺o	wiki
cablo	käːbl̺o̞	wiki
cacarella	käkär̺ɛl̺l̺ä	wiki
cacca	käkːä	wiki
caccamo	käːkamo̞	wiki
cacchio	käkk̟jo	wiki
cacciare	kattʃare	wiki
cacciata	kätt͡ʃäːt̪ä	wiki
caciaio	kät͡ʃäːjo	wiki
caciaro	kät͡ʃäːr̺o̞	wiki
cacimperio	kät͡ʃimpɛːr̺jo	wiki
cacio	käːt͡ʃo	wiki
caciocavallo	kät͡ʃo̞käväl̺ːo̞	wiki
cacume	käkuːme	wiki
cacuminale	käkumin̺äːl̺e̞	wiki
caendo	käɛn̪d̪o	wiki
cagliare	käʎːäːre	wiki
calabria	käl̺äːbr̺jä	wiki
calabrone	käl̺äbr̺o̞ːn̺e	wiki
calanca	käl̺äŋkä	wiki
calcestruzzo	käl̺ʲt͡ʃe̞s̪t̪r̺ut̪t̪͡s̪o	wiki
calcio	käl̠ʲt͡ʃo	wiki
caldarrosta	käl̺d̪är̺r̺ɔs̪t̪ä	wiki
calderino	käl̪d̪e̞r̺iːn̺o	wiki
calderugia	käl̪d̪e̞r̺uːd͡ʒä	wiki
calderugio	käl̪d̪e̞r̺uːd͡ʒo	wiki
caldo	kaldo	wiki
calibe	käːl̺ibe	wiki
calibeato	käl̺ibeäːt̪o̞	wiki
calibotipia	käl̺ibot̪ipiä̯	wiki
calice	käːl̺it͡ʃe	wiki
califfato	kal̺iffaːt̪o	wiki
califfo	kal̺iffo	wiki
calle	källe̞	wiki
calliope	käl̪l̪io̯pe	wiki
calliope	käl̺l̺io̯pe	wiki
caltanissetta	käl̪t̪änisːet̪ːä	wiki
calzare	käl̺t̪͡s̪äːr̺e̞	wiki
cambiare	kämbjäːr̺e̞	wiki
cambio	kämbjo̞	wiki
cambra	kämbr̺ä	wiki
cameraman	käːme̞r̺ämɛn̺	wiki
camerata	kamer̺aːt̪a	wiki
camicia	kämiːt͡ʃä	wiki
camo	käːmo̞	wiki
campagnolo	kampaɲɲɔːl̺o	wiki
campanellino	kämpänelːiːno	wiki
campania	kämpäːnjä	wiki
campidoglio	kämpid̪ɔʎʎo	wiki
can	kän̺	wiki
cana	käːn̺ä	wiki
canapa	kän̺äpä	wiki
canape	kän̺äpe̞	wiki
canapiglia	kän̺äpiʎʎä	wiki
canapo	kän̺äpo̞	wiki
candela	kän̪d̪eːl̺ä	wiki
candi	kän̪d̪i	wiki
candidabilità	kan̪d̪id̪abil̺it̪a	wiki
candido	kän̪d̪id̪o	wiki
candire	kän̪d̪iːr̺e	wiki
candito	kän̪d̪iːt̪o	wiki
cane	käːn̺e̞	wiki
canederlo	kän̺eːd̪er̺l̺o̞	wiki
canederlo	kän̺ɛːd̪er̺l̺o̞	wiki
cangia	kän̺ʲd͡ʒä	wiki
cangiante	kän̺ʲd͡ʒän̪t̪e̞	wiki
canguro	käŋɡuːr̺o	wiki
canizie	kän̺it̪t̪͡s̪je	wiki
canna	kän̺n̺ä	wiki
cannibale	kän̺n̺iːbäl̺e̞	wiki
cannibalesco	kän̺n̺ibäl̺e̞s̪ko	wiki
cannibalizzare	kän̺ːibäl̺id̪d̪͡z̪äːr̺e̞	wiki
cannibalizzazione	kän̺ːibäl̺id̪͡ːz̪at̪͡s̪joːn̺e	wiki
cannolo	känːɔːlo	wiki
cannonare	kän̺n̺o̞n̺äːr̺e̞	wiki
cannonata	kän̺n̺o̞n̺äːt̪ä	wiki
cannone	kän̺n̺o̞ːn̺e	wiki
cannoneggiamento	kän̺n̺o̞n̺edd͡ʒäme̞n̪t̪o	wiki
cannoneggiare	kän̺n̺o̞n̺edd͡ʒäːr̺e̞	wiki
cannoniera	kän̺n̺o̞n̺jɛːr̺ä	wiki
cannoniere	kän̺n̺o̞n̺jɛːr̺e	wiki
cannoniero	kän̺n̺o̞n̺jɛːr̺o	wiki
cano	käːn̺o̞	wiki
cantautore	kän̪t̪äu̯t̪oːre	wiki
cantautrice	kän̪t̪äu̯t̪riːt͡ʃe	wiki
canuto	kän̺uːt̪o	wiki
canutola	kän̺uːt̪ol̺ä	wiki
canzio	kän̪t̪͡s̪jo	wiki
cao	käːo	wiki
caos	käːos̪	wiki
caosse	käɔs̪ːe	wiki
caotico	käɔːt̪iko	wiki
capelli	kapelli	wiki
capelvenere	käpe̞l̺vɛːn̺er̺e	wiki
capitergio	käpit̪ɛr̺d͡ʒo	wiki
capitolino	käpit̪ol̺iːn̺o	wiki
capitolino	käpiːt̪ol̺in̺o	wiki
capivoltare	käpivol̪t̪äːr̺e̞	wiki
capo	kaːpo	wiki
capovolgere	käpo̞vɔl̺ʲd͡ʒer̺e	wiki
capovoltare	käpo̞vol̪t̪äːr̺e̞	wiki
capovoltarsi	käpo̞vol̪t̪är̺s̪i	wiki
capozzo	käpɔt̪t̪͡s̪o	wiki
cappa	käppä	wiki
cappare	käppäːr̺e̞	wiki
caprigno	käpr̺iɲɲo	wiki
caracalla	kär̺äkäl̺l̺ä	wiki
caracca	kär̺äkkä	wiki
carattere	kär̺ät̪t̪e̞r̺e	wiki
carbonara	kärbonäːrä	wiki
carbonio	kär̺bɔːn̺jo	wiki
carcino	kär̺t͡ʃin̺o	wiki
card	kär̺d̪	wiki
cardinale	kär̺d̪in̺äːl̺e̞	wiki
cardinalizio	kär̺d̪in̺äl̺it̪͡ːs̪jo	wiki
cardiocinetico	kär̺d̪jot͡ʃin̺ɛːt̪iko	wiki
carducciano	kärdut͡ːʃäːno	wiki
cariaco	kär̺jäːko̞	wiki
caricatura	kär̺ikät̪uːr̺ä	wiki
carini	käriːniː	wiki
carne	kär̺n̺e̞	wiki
carnificazione	kär̺n̺ifikät̪t̪͡s̪joːn̺e	wiki
carnoso	kär̺n̺o̞ːz̪o	wiki
carota	kaɾɔːt̪a	wiki
carotare	kaɾot̪aːɾe	wiki
carrambata	kärːämbäːt̪ä	wiki
carriera	kärːjɛːrä	wiki
carriere	karrjɛːre	wiki
carroccio	kär̺ːɔt͡ːʃo	wiki
carruca	kär̺r̺uːkä	wiki
carrucola	kär̺r̺uːkol̺ä	wiki
cartagine	kär̺t̪äːdʒin̺e	wiki
cartaginese	kär̺t̪͡ädʒin̺eːz̪e	wiki
cartellata	kärt̪elːäːt̪ä	wiki
cartilagine	kär̺t̪il̺äːdʒin̺e	wiki
cartongessista	kärt̪on̠ʲd͡ʒes̪ːis̪t̪ä	wiki
cartongesso	kärt̪on̠ʲd͡ʒɛs̪ːo	wiki
casalese	käzäleːse	wiki
casalese	käzäleːze	wiki
casata	käsäːt̪ä	wiki
casata	käzäːt̪ä	wiki
casino	kaziːno	wiki
cassa	käs̪s̪ä	wiki
cassapanca	käs̪s̪äpäŋkä	wiki
cassata	käsːäːt̪ä	wiki
cassida	käs̪s̪id̪ä	wiki
cassida	käs̪s̪iːd̪ä	wiki
casside	käs̪s̪id̪e	wiki
casside	käs̪s̪iːd̪e	wiki
cassidide	käs̪s̪iːd̪id̪e	wiki
casso	käs̪s̪o̞	wiki
cast	käs̪t̪	wiki
castello	kast̪ɛlːo	wiki
casto	käs̪t̪o̞	wiki
castone	käs̪t̪oːn̺e	wiki
catafratta	kät̪äfr̺ät̪t̪a	wiki
catafratto	kät̪äfr̺ät̪t̪o̞	wiki
catai	kät̪äi̯	wiki
catalogo	kät̪äːl̺o̞ɡo	wiki
catana	kät̪äːn̺ä	wiki
catarifrangente	kät̪är̺ifr̺än̺ʲd͡ʒɛn̪t̪e	wiki
catastematico	kät̪äs̪t̪e̞mäːt̪iko	wiki
catasterismo	kät̪äs̪t̪e̞r̺iz̪mo	wiki
categoria	kät̪e̞ɡor̺iä̯	wiki
catello	kät̪ɛl̺ːo	wiki
catenaccio	katenat̚tʃo	wiki
catilina	kät̪il̺iːn̺ä	wiki
catilinaria	kät̪il̺in̺äːr̺jä	wiki
catilinario	kät̪il̺in̺äːr̺jo̞	wiki
catone	kät̪o̞ːn̺e	wiki
catoneggiare	kät̪o̞n̺edd͡ʒäːr̺e̞	wiki
cattaneo	kät̪ːäːneo	wiki
cattedrale	kät̪t̪e̞d̪r̺äːl̺e̞	wiki
caudio	käu̯d̪jo	wiki
caudium	käu̯d̪jum	wiki
caulerpa	käu̯l̺ɛr̺pä	wiki
causale	käu̯z̪äːl̺e̞	wiki
causalismo	käu̯z̪al̺iz̪mo	wiki
causalista	käu̯z̪al̺is̪t̪ä	wiki
causalistico	käu̯z̪al̺is̪t̪iko	wiki
causatore	käu̯z̪at̪oːr̺e	wiki
causatrice	käu̯z̪at̪r̺iːt͡ʃe	wiki
causazione	käu̯z̪at̪t̪͡s̪joːn̺e	wiki
cautamente	käu̯t̪äme̞n̪t̪e	wiki
cauterio	käu̯t̪ɛːr̺jo	wiki
cauto	käu̯t̪o	wiki
cauzione	käu̯t̪t̪͡s̪joːn̺e	wiki
cavallo	kavallo	wiki
cavea	käːve̞ä	wiki
cavea	käːve̯ä	wiki
cavedano	käve̞ːd̪än̺o̞	wiki
cavedine	käve̞ːd̪in̺e	wiki
cavobuono	kävo̞bwɔːn̺o	wiki
cazzimperio	kät̪͡ːs̪impɛːr̺jo	wiki
cazzo	kät̪t͡s̪o̞	wiki
cazzuola	kät̪͡ːs̪wɔːl̺ä	wiki
cecchinaggio	t͡ʃekk̟in̺ädd͡ʒo̞	wiki
cecchino	t͡ʃekk̟iːn̺o	wiki
cediglia	t͡ʃed̪iʎːä	wiki
cedrangolo	t͡ʃed̪r̺äŋɡo̞l̺o	wiki
cefalo	t͡ʃɛːfäl̺o̞	wiki
cela	t͡ʃɛːl̺ä	wiki
celacanto	t͡ʃel̺äkän̪t̪o̞	wiki
celere	t͡ʃɛːl̺er̺e	wiki
celermente	t͡ʃel̺er̺men̪t̪e	wiki
celsitudine	t͡ʃel̺s̪it̪uːd̪in̺e	wiki
cempenna	t͡ʃempen̺n̺ä	wiki
cempennare	t͡ʃempen̺n̺äːr̺e̞	wiki
cenerentola	t͡ʃen̺er̺ɛn̪t̪ol̺ä	wiki
ceneri	tʃeneri	wiki
centinaio	t͡ʃen̪t̪inäːjo	wiki
centinervia	t͡ʃen̪t̪in̺ɛr̺vjä	wiki
centonervi	t͡ʃen̪t̪on̺ɛr̺vi	wiki
centonervia	t͡ʃen̪t̪on̺ɛr̺vjä	wiki
centosei	t͡ʃɛn̪t̪os̪ɛːi̯	wiki
centreuropeo	t͡ʃen̪t̪r̺eu̯r̺opɛːo	wiki
centroeuropeo	t͡ʃɛn̪t̪r̺oeu̯r̺opɛːo	wiki
centuplicare	t͡ʃen̪t̪upl̺ikäːr̺e̞	wiki
centurione	t͡ʃen̪t̪ur̺joːn̺e	wiki
cera	t͡ʃeːra	wiki
cerco	t͡ʃer̺ko	wiki
cerda	t͡ʃeːrda	wiki
ceroplaste	t͡ʃer̺opl̺äs̪t̪e̞	wiki
ceroplastica	t͡ʃer̺opl̺äs̪t̪ikä	wiki
ceroplastico	t͡ʃer̺opl̺äs̪t̪iko	wiki
cervello	t͡ʃer̺vɛl̺ːo	wiki
cervo	t͡ʃɛr̺vo	wiki
cesarea	t͡ʃezär̺ɛːä	wiki
cesareo	t͡ʃezär̺ɛːo	wiki
cesareo	t͡ʃezäːr̺eo	wiki
cesareo	t͡ʃezäːr̺e̯o	wiki
cesco	t͡ʃes̪ko	wiki
cessa	t͡ʃɛs̪s̪a	wiki
charmonio	t͡ʃär̺mɔːn̺jo	wiki
chat	t͡ʃät̪	wiki
checchessia	k̟ek̟ːesːiːä	wiki
chemionastia	kɛmjon̺äs̪t̪iä̯	wiki
chemionastia	kɛmjon̺äs̪t̪iːä	wiki
chemionastico	kɛmjon̺äs̪t̪iko	wiki
chente	kɛn̪t̪e	wiki
cheope	kɛːope	wiki
cheratocono	k̟er̺ät̪o̞kɔːn̺o	wiki
cheratoglobo	ker̺ät̪o̞ɡl̺ɔːbo	wiki
cheratoplastica	ker̺ät̪o̞pl̺äs̪t̪ikä	wiki
cheratoplastico	ker̺ät̪o̞pl̺äs̪t̪iko	wiki
cherere	kɛːr̺er̺e	wiki
chetogenetico	ket̪od͡ʒen̺ɛːt̪iko	wiki
chetoplastico	ket̪opl̺äs̪t̪iko	wiki
chi	k̟i	wiki
chiacchiera	k̟jäk̟ːjerä	wiki
chiacchierare	k̟jäkk̟jer̺äːr̺e̞	wiki
chianti	k̟jän̪t̪i	wiki
chiantigiano	k̟jän̪t̪id͡ʒäːno	wiki
chiappa	k̟jäpːä	wiki
chiarire	kjariːre	wiki
chiaro	k̟jäːr̺o̞	wiki
chiaroscuro	k̟järoskuːro	wiki
chiasmo	k̟jäz̪mo̞	wiki
chiatta	k̟jät̪ːä	wiki
chiatto	k̟jät̪ːo	wiki
chiavare	kjäväːr̺e̞	wiki
chiavo	kjäːvo̞	wiki
chicago	t͡ʃikäːɡo	wiki
chicago	ʃikäːɡo	wiki
chicchessia	k̟ik̟ːesːiːä	wiki
chicco	k̟ikko	wiki
chierere	kjɛːr̺er̺e	wiki
chierica	kjɛrika	wiki
chierico	kjeriko	wiki
chiesucola	k̟jez̪uːkol̺ä	wiki
chietino	k̟jet̪iːn̺o	wiki
chiglia	k̟iʎːä	wiki
chiliagono	k̟il̺jäːɡo̞n̺o	wiki
chiliogono	k̟il̺jɔːɡon̺o	wiki
chimango	t͡ʃimäŋɡo̞	wiki
chimo	k̟iːmo	wiki
chino	kiːno	wiki
chiodino	kjod̪iːn̺o	wiki
chiodino	kjɔːd̪in̺o	wiki
chirografo	k̟ir̺ɔːɡr̺äfo̞	wiki
chiuino	kjuiːn̺o	wiki
chiunque	k̟iuŋkwe	wiki
chiuso	k̟juːz̪o	wiki
cialtrone	t͡ʃäl̺t̪r̺o̞ːn̺e	wiki
ciambella	t͡ʃämbɛl̺ːä	wiki
cianca	t͡ʃäŋkä	wiki
cianfrusaglia	t͡ʃäɱfr̺uz̪äʎʎä	wiki
ciano	tʃiːän̺o̞	wiki
ciazio	t͡ʃiät̪t̪͡s̪jo	wiki
cibernetico	t͡ʃibeɾnɛtiko	wiki
ciberspazio	sajbeɾspat͡sjo	wiki
ciberspazio	t͡ʃibeɾspat͡sjo	wiki
cibo	t͡ʃiːbo̞	wiki
ciccio	t͡ʃitt͡ʃo	wiki
cicerbita	t͡ʃit͡ʃer̺bit̪ä	wiki
cicisbeare	t͡ʃit͡ʃiz̪beäːr̺e̞	wiki
cicisbeatura	t͡ʃit͡ʃiz̪beät̪uːr̺ä	wiki
cicisbeismo	t͡ʃit͡ʃiz̪beiz̪mo	wiki
cicisbeo	t͡ʃit͡ʃiz̪bɛːo	wiki
ciclabile	t͡ʃikl̺äːbil̺e	wiki
ciclaggio	t͡ʃikl̺ädd͡ʒo̞	wiki
ciclicità	t͡ʃikl̺it͡ʃit̪ä	wiki
ciclico	t͡ʃiːkl̺iko	wiki
ciclo	t͡ʃiːkl̺o	wiki
cicloconio	t͡ʃikl̺okɔːn̺jo	wiki
ciclopropano	t͡ʃikl̺opr̺opäːn̺o̞	wiki
cidonio	t͡ʃid̪ɔːn̺jo	wiki
cieco	t͡ʃeːko	wiki
ciliege	t͡ʃiljɛːd͡ʒe	wiki
ciliegia	t͡ʃiljɛːd͡ʒä	wiki
ciliegie	t͡ʃiljɛːd͡ʒe	wiki
cimasa	t͡ʃimäːz̪ä	wiki
cimazio	t͡ʃimät̪t̪͡s̪jo	wiki
cincia	t͡ʃin̺ʲt͡ʃä	wiki
cinciallegra	t͡ʃin̺ʲt͡ʃälːeːɡr̺ä	wiki
cincinnare	t͡ʃin̺ʲt͡ʃin̺n̺äːr̺e̞	wiki
cincinnarsi	t͡ʃin̺ʲt͡ʃin̺n̺är̺s̪i	wiki
cincinnato	t͡ʃin̺ʲt͡ʃin̺n̺äːt̪o̞	wiki
cincinno	t͡ʃin̺ʲt͡ʃin̺n̺o	wiki
cinegetico	t͡ʃin̺ed͡ʒɛːt̪iko	wiki
cinema	t͡ʃiːn̺emä	wiki
cinisi	ʃiːnisiː	wiki
cinocefalide	t͡ʃin̺ot͡ʃefäːl̺id̪e	wiki
cinocefalo	t͡ʃin̺ot͡ʃɛːfäl̺o̞	wiki
cinquanta	t͡ʃiŋkwan̪t̪a	wiki
cinquantuno	t͡ʃiŋkwän̪t̪uːn̺o	wiki
cinque	t͡ʃiŋkwe	wiki
cinquedea	t͡ʃiŋkwed̪ɛːä	wiki
cinquenne	t͡ʃiŋkwɛn̺n̺e	wiki
cioccolata	t͡ʃokːol̺äːt̪ä	wiki
cioccolato	t͡ʃokːol̺äːt̪o̞	wiki
ciondolino	t͡ʃon̪d̪ol̺in̺o	wiki
ciondolino	t͡ʃon̪d̪ol̺iːn̺o	wiki
cipango	t͡ʃipäŋɡo	wiki
cipria	t͡ʃiːpr̺jä	wiki
ciprio	t͡ʃiːpr̺jo	wiki
circonflesso	t͡ʃir̺koɱfl̺ɛs̪s̪o	wiki
circonlocuzione	t͡ʃir̺kon̺l̺okut̪͡s̪joːn̺e	wiki
circumcirca	t͡ʃir̺kumt͡ʃir̺kä	wiki
circumnavigazione	t͡ʃirkunːäviɡät̪͡s̪ːjoːne	wiki
cisticerco	t͡ʃis̪t̪it͡ʃɛr̺ko	wiki
citta	t͡ʃit̪ːä	wiki
citta	ʃit̪ːä	wiki
cittade	t͡ʃit̪t̪äːd̪e	wiki
citto	t͡ʃit̪ːo	wiki
citto	ʃit̪ːo	wiki
città	t͡ʃit̪t̪ä	wiki
ciuffolotto	t͡ʃuffol̺ɔt̪t̪o	wiki
cive	t͡ʃiːve	wiki
ciò	tʃɔ	wiki
clangere	kl̺än̺ʲd͡ʒe̞r̺e	wiki
claudicante	kl̺au̯d̪ikän̪t̪e̞	wiki
claudicare	kl̺au̯d̪ikäːr̺e̞	wiki
claustro	kl̺äu̯s̪t̪r̺o	wiki
claustrofilia	kl̺äu̯s̪t̪r̺ofil̺iä̯	wiki
claustrofilo	kl̺äu̯s̪t̪r̺ɔːfil̺o	wiki
claustrofobia	kl̺äu̯s̪t̪r̺ofobiä̯	wiki
claustrofobico	kl̺äu̯s̪t̪r̺ofɔːbiko	wiki
clausura	kl̺äu̯zuːrä	wiki
climb	kl̺äi̯mb	wiki
clonare	kl̺on̺aːr̺e	wiki
clonazione	kl̺on̺at̪͡s̪joːn̺e	wiki
cloro	kl̺ɔːr̺o	wiki
clotoide	kl̺otɔi̯d̪e	wiki
clune	kl̺uːn̺e	wiki
coalizione	ko̯äl̺it̪t̪͡s̪joːn̺e	wiki
coalizzare	ko̯äl̺id̪d̪͡z̪äːr̺e̞	wiki
cobaltatura	kobäl̺t̪ät̪uːr̺ä	wiki
cobaltico	kobäl̺t̪iko	wiki
cobalto	kobäl̺t̪o̞	wiki
cobaltoso	kobäl̺t̪o̞ːz̪o	wiki
cobra	kɔːbr̺ä	wiki
cobralisina	kobr̺äl̺iz̪iːn̺ä	wiki
cobraterapia	kobr̺ät̪e̞r̺äpiä̯	wiki
cobraterapia	kobr̺ät̪e̞r̺äpiːä	wiki
cobratossina	kobr̺ät̪o̞s̪s̪iːn̺ä	wiki
cocalina	kokäl̺iːn̺ä	wiki
cocimento	kot͡ʃimen̪t̪o	wiki
cocomero	kokoːmer̺o	wiki
coda	koda	wiki
codesto	kod̪es̪t̪o	wiki
codibianco	kod̪ibjäŋko̞	wiki
codicologia	kod̪ikol̺od͡ʒiä̯	wiki
codimozzo	kod̪imot̪t̪͡s̪o	wiki
cofto	kɔft̪o	wiki
cogli	koʎʎi	wiki
cogli	kɔʎʎi	wiki
coglia	koʎʎä	wiki
coglie	koʎʎe	wiki
coglie	kɔʎʎe	wiki
coglione	koʎːoːn̺e	wiki
coitare	koi̯t̪äːr̺e	wiki
colaggiuso	kol̺ädd͡ʒuːz̪o	wiki
colaggiù	kol̺ädd͡ʒu	wiki
colassuso	kol̺äs̪s̪uːz̪o	wiki
colassù	kol̺äs̪s̪u	wiki
colere	kɔːl̺er̺e	wiki
colla	kolla	wiki
colla	kɔlla	wiki
colle	kol̺l̺e	wiki
colle	kɔl̺l̺e	wiki
collisione	kollizjoːne	wiki
collo	kol̺l̺o	wiki
collo	kɔl̺l̺o	wiki
collottola	kol̺l̺ɔt̪t̪ol̺ä	wiki
colo	koːl̺o	wiki
colo	kɔːl̺o	wiki
colombaccio	kol̺ombätt͡ʃo̞	wiki
colombina	kol̺ombiːn̺ä	wiki
colombino	kol̺ombiːn̺o	wiki
colpire	kolpire	wiki
coltello	kol̪t̪ɛl̺l̺o	wiki
coltivare	kol̪t̪iväːr̺e̞	wiki
coltivo	kol̪t̪iːvo	wiki
colto	kol̪t̪o	wiki
colto	kɔl̪t̪o	wiki
coltra	kol̪t̪r̺ä	wiki
coltre	kol̪t̪r̺e	wiki
coltrice	kol̪t̪r̺it͡ʃe	wiki
coltro	kol̪t̪r̺o	wiki
colubro	kol̺uːbr̺o	wiki
colubro	kɔːl̺ubr̺o	wiki
colugo	kol̺uːɡo	wiki
comare	komäːre	wiki
combattere	kombattere	wiki
combriccola	kombr̺ikːol̺ä	wiki
comedo	komɛːd̪o	wiki
comicità	komit͡ʃit̪ä	wiki
comico	kɔːmiko	wiki
comito	kɔːmit̪o	wiki
commediare	kommed̪jäːr̺e̞	wiki
compagine	kompäːdʒin̺e	wiki
compagnia	kompäɲɲiːä	wiki
compagno	kompäɲɲo̞	wiki
compare	kompäːre	wiki
computer	kompjuːt̪er̺	wiki
comunismo	komun̺iz̪mo	wiki
comunista	komun̺is̪t̪ä	wiki
comunisteggiante	komun̺is̪t̪edd͡ʒän̪t̪e̞	wiki
comunisteggiare	komun̺is̪t̪edd͡ʒäːr̺e̞	wiki
comunistizzare	komun̺is̪t̪id̪d̪͡z̪äːr̺e̞	wiki
comunque	komuŋkwe	wiki
conca	koŋkä	wiki
concettuale	kon̺ʲt͡ʃet̪t̪wäːl̺e̞	wiki
concilio	kon̺ʲt͡ʃiːl̺jo	wiki
concinnità	kon̺ʲt͡ʃin̺n̺it̪ä	wiki
concinno	kon̺ʲt͡ʃin̺n̺o	wiki
conciossiaché	kon̺ʲt͡ʃɔs̪s̪jäk̟e̞	wiki
conciossiacosaché	kon̺ʲt͡ʃɔs̪s̪jäkɔz̪äk̟e̞	wiki
concola	koŋkol̺ä	wiki
concretizzarsi	koŋkr̺et̪id̪d̪͡z̪är̺s̪i	wiki
concubito	koŋkuːbit̪o	wiki
concupiscente	koŋkupiʃʃɛn̪t̪e	wiki
condoglianza	kon̪d̪oʎʎän̪t̪͡s̪ä	wiki
condolersi	kon̪d̪ol̺er̺s̪i	wiki
condrotomo	kon̪d̪r̺ɔːt̪omo	wiki
condurango	kon̪d̪ur̺äŋɡo̞	wiki
confederale	koɱfed̪er̺äːl̺e̞	wiki
confederalismo	koɱfed̪er̺äl̺iz̪mo	wiki
confederalista	koɱfed̪er̺äl̺is̪t̪ä	wiki
confederare	koɱfed̪er̺äːr̺e̞	wiki
confederarsi	koɱfed̪er̺är̺s̪i	wiki
confederativo	koɱfed̪er̺ät̪iːvo	wiki
confederato	koɱfed̪er̺äːt̪o̞	wiki
confederazione	koɱfed̪er̺ät̪t͡sjoːn̺e̞	wiki
confidamento	koɱfid̪äme̞n̪t̪o	wiki
confidare	koɱfid̪äːr̺e̞	wiki
confidarsi	koɱfid̪är̺s̪i	wiki
confidente	koɱfid̪ɛn̪t̪e	wiki
confidenza	koɱfid̪ɛn̪t̪͡s̪ä	wiki
confidenziale	koɱfid̪en̪t̪͡s̪jäːl̺e̞	wiki
confidenzialità	koɱfid̪en̪t̪͡s̪jäl̺it̪ä	wiki
confidenzialmente	koɱfid̪en̪t̪͡s̪jäl̺me̞n̪t̪e	wiki
congelatore	kon̺ʲd͡ʒel̺äto̞ːr̺e	wiki
congenere	kon̺ʲd͡ʒɛːn̺er̺e	wiki
congiunzione	kon̺ʲd͡ʒun̪t̪͡s̪joːn̺e	wiki
congiura	kon̺d͡ʒuːr̺ä	wiki
congiurare	kon̺ʲd͡ʒur̺äːr̺e̞	wiki
congiurato	kon̺ʲd͡ʒur̺äːt̪o̞	wiki
congiuratore	kon̺ʲd͡ʒur̺ät̪o̞ːr̺e	wiki
congiurazione	kon̺ʲd͡ʒur̺ät̪t̪͡s̪joːn̺e	wiki
connessione	kon̺ːes̪s̪joːn̺e	wiki
conno	kon̺n̺o	wiki
conoscere	kon̺oʃʃer̺e	wiki
conquibus	koŋkwiːbus	wiki
conquistare	koŋkwis̪t̪aːr̺e̞	wiki
consacrando	kon̪s̪äkr̺än̪d̪o̞	wiki
conseguire	kon̪s̪eɡwiːr̺e	wiki
consobrino	kon̪s̪obr̺iːn̺o	wiki
console	kon̪s̪ɔl̪	wiki
console	kɔn̪s̪ol̪e	wiki
consonante	kon̪s̪on̺än̪t̪e̞	wiki
contemnendo	kon̪t̪emn̺ɛn̪d̪o	wiki
contennendo	kon̪t̪en̺n̺ɛn̪d̪o	wiki
contentare	kon̪t̪en̪t̪äːr̺e̞	wiki
contento	kon̪t̪ɛn̪t̪o	wiki
contesa	kon̪t̪eːz̪ä	wiki
conteso	kon̪t̪eːz̪o	wiki
contessere	kon̪t̪ɛs̪s̪er̺e	wiki
contra	kon̪t̪r̺ä	wiki
contro	kon̪t̪r̺o	wiki
controconio	kon̪t̪r̺okɔːn̺jo	wiki
controproducente	kon̪t̪r̺opr̺od̪ut͡ʃɛn̪t̪e	wiki
contropunta	kon̪t̪r̺opun̪t̪ä	wiki
convalligiano	koɱväl̺l̺id͡ʒäːn̺o̞	wiki
convocare	koɱvokäːr̺e̞	wiki
convocazione	koɱvokät̪͡s̪joːn̺e	wiki
copernicio	koper̺n̺iːt͡ʃo	wiki
copia	kɔːpja	wiki
copto	kɔpt̪o	wiki
copula	kɔːpul̺ä	wiki
corazza	kor̺ät̪t̪͡s̪ä	wiki
corbo	kɔr̺bo	wiki
corda	kɔrda	wiki
coreggia	kor̺edd͡ʒa	wiki
coridale	kor̺id̪äːl̺e̞	wiki
corion	kɔːr̺jon̺	wiki
cornare	kor̺n̺äːr̺e̞	wiki
cornetto	kor̺n̺et̪t̪o	wiki
cornicine	kor̺n̺iːt͡ʃin̺e	wiki
corporeo	kor̺pɔːr̺eo	wiki
corporeo	kor̺pɔːr̺e̯o	wiki
correggia	kor̺r̺edd͡ʒa	wiki
correre	kor̺r̺er̺e	wiki
corroboramento	kor̺r̺obor̺äme̞n̪t̪o	wiki
corroborare	kor̺r̺obor̺äːr̺e̞	wiki
corroboratore	kor̺r̺obor̺ät̪o̞ːr̺e	wiki
corroboratrice	kor̺r̺obor̺ät̪r̺iːt͡ʃe	wiki
corrotto	kor̺r̺ot̪t̪o	wiki
corruscare	kor̺r̺us̪käːr̺e̞	wiki
corruschio	kor̺r̺us̪k̟iːo	wiki
corrusco	kor̺r̺us̪ko	wiki
corruzione	kor̺r̺ut̪t̪͡s̪joːn̺e	wiki
corsa	kor̺s̪ä	wiki
corsa	kɔr̺s̪ä	wiki
corse	kor̺s̪e	wiki
corse	kɔr̺s̪e	wiki
corsesca	kor̺s̪es̪kä	wiki
corsi	kor̺s̪i	wiki
corsi	kɔr̺s̪i	wiki
corsica	kɔr̺s̪ikä	wiki
corso	kor̺s̪o	wiki
corso	kɔr̺s̪o	wiki
corteccia	kortettʃa	wiki
corto	korto	wiki
cortona	kor̺t̪oːn̺ä	wiki
cortonese	kor̺t̪on̺eːz̪e	wiki
cosacco	koz̪äkko̞	wiki
coserella	koz̪e̞r̺ɛl̺l̺ä	wiki
cosiffattamente	koz̪iffät̪t̪äme̞n̪t̪e	wiki
cosiffatto	koz̪iffät̪t̪o̞	wiki
cotanto	kot̪än̪t̪o	wiki
cotenna	kot̪en̺n̺ä	wiki
cotennotto	kot̪enːɔt̪ːo	wiki
cotesto	kot̪es̪t̪o	wiki
cotevesto	kot̪eːves̪t̪o	wiki
cotica	koːt̪ikä	wiki
cotico	koːt̪iko	wiki
cotogna	kot̪oɲːä	wiki
cotogno	kot̪oɲːo	wiki
creatura	kr̺eä̯t̪uːr̺ä	wiki
creditizio	kr̺ed̪it̪it̪͡ːs̪jo	wiki
crepitare	kr̺epit̪äːr̺e̞	wiki
crescita	kr̺eʃʃit̪ä	wiki
cresimando	kr̺ez̪imän̪d̪o̞	wiki
creso	kr̺eːz̪o	wiki
crespino	kr̺es̪pin̺o	wiki
crespino	kr̺es̪piːn̺o	wiki
crettare	kr̺et̪t̪äːr̺e̞	wiki
crettarsi	kr̺et̪t̪är̺s̪i	wiki
crettatura	kr̺et̪t̪ät̪uːr̺ä	wiki
cretto	kr̺ɛt̪t̪o	wiki
cricca	kr̺ikkä	wiki
criselefantina	kr̺iz̪el̺efan̪t̪iːn̺a	wiki
criselefantine	kr̺iz̪el̺efan̪t̪iːn̺e	wiki
criselefantini	kr̺iz̪el̺efan̪t̪iːn̺i	wiki
criselefantino	kr̺iz̪el̺efän̪t̪iːn̺o	wiki
crisocalco	kr̺iz̪okäl̺ko̞	wiki
crisoelefantino	kr̺iz̪o̯el̺efän̪t̪iːn̺o	wiki
cristallo	kr̺is̪t̪äl̺ːo̞	wiki
cristalloblastico	kr̺is̪t̪äl̺l̺o̞bl̺äs̪t̪iko	wiki
cristalloclastico	kr̺is̪t̪äl̺l̺o̞kl̺äs̪t̪iko	wiki
cristallografo	kr̺is̪t̪äl̺l̺ɔːɡr̺äfo̞	wiki
cristo	kr̺is̪t̪o	wiki
cristocentrismo	kr̺is̪t̪ot͡ʃen̪t̪r̺iz̪mo	wiki
cristologia	kr̺is̪t̪ol̺od͡ʒiːä	wiki
crocerossina	kr̺ot͡ʃer̺os̪s̪iːn̺ä	wiki
crocesegnare	kr̺ot͡ʃes̪eɲɲäːr̺e̞	wiki
crocesignare	kr̺ot͡ʃes̪iɲɲäːr̺e̞	wiki
croio	kr̺ɔːjo	wiki
cromo	kr̺ɔːmo	wiki
cronico	kr̺ɔːn̺iko	wiki
crosta	kr̺ɔs̪t̪ä	wiki
crostaceo	krost̪aːtʃ͡eo	wiki
crurale	kr̺ur̺äːl̺e̞	wiki
crusca	kruska	wiki
ctonio	kt̪ɔːn̺jo	wiki
cucchiaia	kukkjäːjä	wiki
cucchiara	kukkjäːr̺ä	wiki
cucciolo	kutt͡ʃol̺o	wiki
cucina	lakutʃiːna	wiki
cucinare	kut͡ʃin̺äːr̺e̞	wiki
cucire	kutʃire	wiki
culaccino	kul̺ätt͡ʃiːn̺o	wiki
culaccio	kul̺ätt͡ʃo̞	wiki
culminale	kul̺min̺äːl̺e̞	wiki
culo	kuːl̺o	wiki
culto	kul̪t̪o	wiki
cultore	kul̪t̪oːr̺e	wiki
cuna	kuːn̺ä	wiki
cuneiforme	kun̺ei̯for̺me	wiki
cuneo	kuːneo	wiki
cuneo	kuːne̯o	wiki
cuorcontento	kwɔr̺kon̪t̪ɛn̪t̪o	wiki
cuore	kwɔːre	wiki
cuoriforme	kwɔr̺ifor̺me	wiki
cupolone	kupol̺oːn̺e	wiki
curbasciata	kur̺bäʃːäːt̪ä	wiki
curbascio	kur̺bäʃːo̞	wiki
cuticagna	kut̪ikäɲɲä	wiki
cyberspazio	sajbeɾspat͡sːjo	wiki
d'oro	d̪ɔːro	wiki
daboia	d̪äbɔːjä	wiki
dalet	d̪äːl̺e̞t̪	wiki
daltonismo	d̪al̺t̪͡on̺iz̪mo	wiki
daniele	d̪än̺jɛːl̺e	wiki
danno	d̪än̺n̺o̞	wiki
dantesco	d̪än̪t̪esko	wiki
danza	d̪än̪t̪͡s̪ä	wiki
danzante	d̪än̪t̪͡s̪än̪t̪e̞	wiki
danzare	d̪än̪t̪͡s̪äːr̺e̞	wiki
danzatore	d̪än̪t̪͡s̪ät̪oːr̺e	wiki
danzatrice	d̪än̪t̪͡s̪ät̪r̺iːt͡ʃe	wiki
dape	d̪äːpe̞	wiki
dappoiché	d̪äppo̞i̯k̟e̞	wiki
dare	d̪äːre	wiki
darmstadtio	d̪är̺ms̪t̪äːd̪jo	wiki
darmstadtio	d̪är̺ms̪t̪äːt̪jo	wiki
darsena	d̪är̺s̪e̞n̺ä	wiki
dattilo	d̪at̪̚t̪ilo	wiki
davante	d̪ävän̪t̪e	wiki
davanti	d̪avan̪t̪i	wiki
dazio	d̪ät̪t̪͡s̪jo	wiki
deandreiano	d̪eän̪d̪r̺e̞jäːn̺o̞	wiki
debuccalizzazione	d̪ebukkäl̺id̪͡ːz̪ät̪t̪͡s̪joːn̺e	wiki
decempeda	d̪et͡ʃɛmped̪ä	wiki
decente	d̪et͡ʃɛn̪t̪e	wiki
decespugliatore	d̪et͡ʃes̪puʎʎät̪o̞ːr̺e	wiki
decevole	d̪et͡ʃeːvol̺e	wiki
decevolmente	d̪et͡ʃevol̺men̪t̪e	wiki
decimoprimo	d̪et͡ʃimopr̺iːmo	wiki
decoro	d̪ekɔːr̺o	wiki
decrepità	d̪ekr̺epit̪ä	wiki
decrescita	dekr̺eʃʃit̪ä	wiki
definire	d̪efin̺iːr̺e	wiki
definito	d̪efin̺iːt̪o	wiki
definizione	d̪efin̺it̪͡s̪joːn̺e	wiki
deflagrare	d̪eflaɡraːre	wiki
deflagrate	d̪eflaɡraːt̪e	wiki
defungere	d̪efun̺ʲd͡ʒer̺e	wiki
defunto	d̪efun̪t̪o	wiki
degenere	d̪ed͡ʒɛːn̺er̺e	wiki
deh	d̪ɛ	wiki
dei	d̪ei̯	wiki
dei	d̪ɛi̯	wiki
deianira	d̪ejän̺iːr̺ä	wiki
deicida	d̪ei̯t͡ʃiːd̪ä	wiki
deimos	deimos̪	wiki
deitade	d̪eit̪aːd̪e	wiki
deitade	d̪ei̯t̪aːd̪e	wiki
deitate	d̪eit̪aːt̪e	wiki
deitate	d̪ei̯t̪aːt̪e	wiki
deità	d̪eit̪a	wiki
deità	d̪ei̯t̪ä	wiki
delatore	d̪el̺ät̪o̞ːr̺e	wiki
delazione	d̪el̺ät̪t̪͡s̪jo̞ːn̺e	wiki
delebile	d̪el̺ɛːbil̺e	wiki
deledda	d̪elɛd̪d̪ä	wiki
deleddiano	d̪eled̪ːjäːno	wiki
deleto	d̪el̺ɛːt̪o	wiki
delezione	d̪el̺et̪t̪͡s̪joːn̺e	wiki
delinquente	d̪el̺iŋkwɛn̪t̪e	wiki
delinquenza	d̪el̺iŋkwɛn̪t̪͡s̪ä	wiki
delinquere	d̪el̺iŋkwer̺e	wiki
delinquito	d̪el̺iŋkwito	wiki
deliro	d̪el̺iːr̺o	wiki
delitto	d̪el̺it̪ːo	wiki
delittore	d̪el̺it̪t̪oːr̺e	wiki
delittuosamente	d̪el̺it̪t̪woz̪äme̞n̪t̪e	wiki
delittuosità	d̪el̺it̪t̪woz̪it̪ä	wiki
delittuoso	d̪el̺it̪t̪woːz̪o	wiki
delubro	d̪el̺uːbr̺o	wiki
democristiano	d̪emokr̺is̪t̪jäːn̺o̞	wiki
demoralizzare	d̪emor̺äl̺id̪d̪͡z̪äːr̺e̞	wiki
demoralizzazione	d̪emor̺äl̺id̪d̪͡z̪ät̪͡s̪joːn̺e	wiki
dentale	d̪en̪t̪äːl̺e̞	wiki
dente	dɛnte	wiki
deodorante	d̪eod̪or̺än̪t̪e̞	wiki
deonomastica	d̪eon̺omäs̪t̪ikä	wiki
deonomastico	d̪eon̺omäs̪t̪iko	wiki
dermascheletro	d̪ɛr̺mäs̪kɛːl̺et̪r̺o	wiki
dermatosclerosi	d̪er̺mät̪o̞s̪kl̺er̺ɔːz̪i	wiki
dermatosclerosi	d̪er̺mät̪o̞s̪kl̺ɛːr̺oz̪i	wiki
deserto	d̪ez̪ɛr̺t̪o	wiki
desiare	d̪ez̪iäːr̺e̞	wiki
desiderio	d̪ez̪id̪ɛːr̺jo	wiki
desidero	d̪ez̪id̪ɛːr̺o	wiki
desidero	d̪ez̪iːd̪er̺o	wiki
desirare	d̪ez̪ir̺äːr̺e̞	wiki
desonorizzazione	d̪es̪on̺or̺id̪͡ːz̪ät̪t̪͡s̪joːn̺e	wiki
destare	d̪es̪t̪äːr̺e̞	wiki
destarsi	d̪es̪t̪är̺s̪i	wiki
destinatario	d̪es̪t̪in̺ät̪äːr̺jo	wiki
destino	d̪es̪t̪iːn̺o	wiki
destino	d̪ɛs̪t̪in̺o	wiki
destro	d̪ɛs̪t̪r̺o	wiki
desultorio	d̪es̪ul̪t̪ɔːr̺jo	wiki
detrudere	d̪et̪r̺uːd̪er̺e	wiki
dettagliare	d̪et̪t̪äʎʎäːr̺e̞	wiki
dettaglio	d̪et̪t̪äʎʎo̞	wiki
deuteragonista	d̪eu̯t̪er̺äɡo̞n̺is̪t̪ä	wiki
devoltare	d̪evol̪t̪äːr̺e̞	wiki
dharma	d̪är̺mä	wiki
di	d̪i	wiki
diablastico	d̪jäbl̺äs̪t̪iko	wiki
diaccio	d̪jätt͡ʃo̞	wiki
diamine	d̪jaːmine	wiki
diamminomonocarbossilico	d̪iämmin̺omɔn̺okär̺bo̞s̪s̪iːl̺iko	wiki
diaspide	d̪iäs̪pid̪e	wiki
diaspide	d̪jäs̪pid̪e	wiki
diaspro	d̪iäs̪pr̺o̞	wiki
diaspro	d̪jäs̪pr̺o̞	wiki
diastole	d̪iaːst̪ole	wiki
diblastico	d̪ibl̺äs̪t̪iko	wiki
dicembre	d̪it͡ʃɛmbr̺e	wiki
dicentra	d̪it͡ʃɛn̪t̪r̺ä	wiki
dicere	d̪iːt͡ʃer̺e	wiki
dicevole	d̪it͡ʃeːvol̺e	wiki
dicevolmente	d̪it͡ʃevol̺men̪t̪e	wiki
diciannove	d̪it͡ʃannɔːve	wiki
diciassette	d̪it͡ʃassɛt̪t̪e	wiki
diciotto	d̪it͡ʃɔt̪t̪o	wiki
dicoriale	d̪ikor̺jäːl̺e̞	wiki
die	d̪iːe	wiki
diece	d̪jɛːt͡ʃe	wiki
dieresi	d̪iɛːr̺ez̪i	wiki
diffida	d̪iffiːd̪ä	wiki
diffidare	d̪iffid̪äːr̺e̞	wiki
diffidato	d̪iffid̪äːt̪o̞	wiki
diffidente	d̪iffid̪ɛn̪t̪e	wiki
diffidenza	d̪iffid̪ɛn̪t̪͡s̪ä	wiki
diffinire	d̪ifːin̺iːr̺e	wiki
diffinito	d̪ifːin̺iːt̪o	wiki
difflugia	d̪iffl̺uːd͡ʒä	wiki
difronte	d̪ifr̺on̪t̪e	wiki
diftongo	d̪ift̪ɔŋɡo	wiki
digradando	d̪iɡr̺äd̪än̪d̪o̞	wiki
dilezione	d̪il̺et̪t̪͡s̪joːn̺e	wiki
diligente	d̪il̺id͡ʒɛn̪t̪e	wiki
diluvio	d̪il̺uːvjo	wiki
diluvium	d̪il̺uːvjum	wiki
dimandare	d̪imän̪d̪äːr̺e	wiki
dimando	d̪imän̪d̪o	wiki
dimane	d̪imäːn̪e	wiki
diminuendo	d̪imin̺uɛn̪d̪o	wiki
diminuendo	d̪imin̺wɛn̪d̪o	wiki
dino	d̪iːn̺o	wiki
dinumerare	d̪in̺umer̺äːr̺e̞	wiki
dio	d̪iːo	wiki
diocesi	d̪iɔːt͡ʃez̪i	wiki
diocesi	d̪jɔːt͡ʃez̪i	wiki
dionisiaco	d̪jon̺iz̪iːäko̞	wiki
dipintore	d̪ipin̪t̪oːr̺e	wiki
dipintrice	d̪ipin̪t̪r̺iːt͡ʃe	wiki
diploblastico	d̪ipl̺obl̺äs̪t̪iko	wiki
diraspatrice	d̪ir̺äs̪pät̪r̺iːt͡ʃe	wiki
dire	d̪iːr̺e	wiki
dischiodare	d̪is̪kjod̪äːr̺e̞	wiki
discoblastico	d̪is̪kobl̺äs̪t̪iko	wiki
disconoscere	d̪is̪kon̺oʃʃer̺e	wiki
disdegnare	d̪iz̪d̪eɲɲäːr̺e̞	wiki
disdegno	d̪iz̪d̪eɲɲo	wiki
disdegnoso	d̪iz̪d̪eɲɲoːz̪o	wiki
disdicevole	d̪iz̪d̪it͡ʃeːvol̺e	wiki
disdire	d̪izd̪iːre	wiki
diserto	d̪iz̪ɛr̺t̪o	wiki
disfattismo	d̪is̪fät̪t̪iz̪mo	wiki
disfattista	d̪is̪fät̪t̪is̪t̪ä	wiki
disfida	d̪is̪fiːd̪ä	wiki
disfidare	d̪is̪fid̪äːr̺e̞	wiki
disianza	d̪iz̪iän̪t̪͡s̪ä	wiki
disiare	d̪iz̪iäːr̺e̞	wiki
disiderio	d̪iz̪id̪ɛːr̺jo	wiki
disinformazione	d̪iz̪iɱfor̺mat̪͡s̪joːn̺e	wiki
disirare	d̪iz̪ir̺äːr̺e̞	wiki
dismaltare	d̪iz̪mäl̪t̪äːr̺e̞	wiki
dismorfosi	d̪iz̪mor̺fɔːz̪i	wiki
disneyano	d̪iznejäːno	wiki
disnodare	d̪iz̪n̺od̪äːr̺e̞	wiki
disnodarsi	d̪iz̪n̺od̪är̺s̪i	wiki
disnoranza	d̪iz̪n̺or̺än̪t̪͡s̪ä	wiki
disobbedire	d̪iz̪obbed̪iːr̺e	wiki
disonoranza	d̪iz̪on̺or̺än̪t̪͡s̪ä	wiki
dispiegamento	d̪is̪pjeɡämen̪t̪o	wiki
dispiegare	d̪is̪pjeɡäːr̺e	wiki
dispregiare	d̪is̪pr̺ed͡ʒäːr̺e̞	wiki
disprezzare	d̪is̪pr̺et̪t̪͡s̪äːr̺e̞	wiki
dissonnare	d̪is̪s̪on̺n̺äːr̺e̞	wiki
disturbo	d̪is̪t̪ur̺bo	wiki
disubbidire	d̪iz̪ubbid̪iːr̺e	wiki
dittinella	d̪it̪t̪in̺ɛl̺l̺ä	wiki
dittongo	d̪it̪t̪ɔŋɡo	wiki
divellere	d̪ivɛl̺l̺er̺e	wiki
divertere	d̪ivɛr̺t̪er̺e	wiki
divertire	d̪iver̺t̪iːr̺e	wiki
divinità	d̪ivin̺it̪ä	wiki
divino	d̪iviːn̺o	wiki
divizia	d̪ivit̪t̪͡s̪jä	wiki
divorare	d̪ivor̺äːr̺e̞	wiki
dizionario	d̪it̪t̪͡s̪jon̺äːr̺jo	wiki
dizione	d̪it̪t̪͡s̪joːn̺e	wiki
dodici	d̪oːd̪it͡ʃi	wiki
doglia	d̪ɔʎʎä	wiki
dolcetto	dol̠ʲt͡ʃet̪ːo	wiki
dolcificante	d̪ol̺ʲt͡ʃifikän̪t̪e̞	wiki
dolcificare	d̪ol̺ʲt͡ʃifikäːr̺e̞	wiki
dolcificato	d̪ol̺ʲt͡ʃifikäːt̪o̞	wiki
dolcificazione	d̪ol̺ʲt͡ʃifikät̪t̪͡s̪jo̞ːn̺e	wiki
dolciura	d̪ol̺t͡ʃuːr̺ä	wiki
dolore	d̪ol̺oːr̺e	wiki
domani	d̪omäːn̪i	wiki
domare	d̪omäːr̺e̞	wiki
domattina	domät̪ːiːnä	wiki
domenica	d̪omeːnikä	wiki
domito	d̪ɔːmit̪o	wiki
domitore	d̪omit̪oːr̺e	wiki
domo	d̪oːmo	wiki
domo	d̪ɔːmo	wiki
donde	d̪on̪d̪e	wiki
doppio	d̪oppjo	wiki
dotto	d̪ot̪ːo	wiki
dotto	d̪ɔt̪ːo	wiki
dove	d̪oːve	wiki
dovunque	d̪ovuŋkwe	wiki
dracena	d̪r̺ät͡ʃɛːn̺ä	wiki
drakar	d̪räːkär	wiki
drakkar	d̪räkːär	wiki
drappeggio	d̪r̺appedd͡ʒo	wiki
drappo	d̪r̺appo	wiki
droga	d̪r̺ɔːɡä	wiki
duale	d̪uäːl̺e̞	wiki
dualmente	d̪wäl̺me̞n̪t̪e	wiki
dubbietà	d̪ubːjet̪ä	wiki
dubitatore	d̪ubit̪ät̪o̞ːr̺e	wiki
dubito	d̪uːbit̪o	wiki
duce	d̪uːt͡ʃe	wiki
ducere	d̪uːt͡ʃer̺e	wiki
due	d̪uːe	wiki
duerno	d̪uɛr̺n̺o	wiki
dugongo	d̪uɡɔŋɡo	wiki
duna	d̪uːn̺ä	wiki
dunque	d̪uŋkwe	wiki
duo	d̪uːo	wiki
duolo	d̪wɔːl̺o	wiki
duomo	d̪wɔːmo	wiki
duramadre	d̪ur̺ämäːd̪r̺e̞	wiki
dì	d̪i	wiki
ebbe	ebbe	wiki
ebbero	ebber̺o	wiki
ebbrietà	ebbr̺jet̪ä	wiki
ebbro	ɛbbr̺o	wiki
ebdomadariamente	ebd̪omäd̪är̺jäme̞n̪t̪e	wiki
ebdomadario	ebd̪omäd̪äːr̺jo	wiki
ebrietà	ebr̺jet̪ä	wiki
ebro	ɛbr̺o	wiki
ecatombe	ekät̪o̞mbe	wiki
ecceità	et͡ːʃei̯t̪ä	wiki
eccellente	ett͡ʃel̺l̺ɛn̪t̪e	wiki
eccetera	ett͡ʃɛːt̪͡e̞r̺a	wiki
ecfrastico	ekfr̺äs̪t̪iko	wiki
ecloga	ɛːkl̺oɡä	wiki
economia	ekon̺omiːä	wiki
edo	ɛːd̪o	wiki
edochiana	ed̪ok̟jäːnä	wiki
edochiano	ed̪ok̟jäːno	wiki
edotto	ed̪ot̪t̪o	wiki
edotto	ed̪ɔt̪t̪o	wiki
efesio	efɛːz̪jo	wiki
effe	ɛffe	wiki
effettivamente	effet̪t̪iväme̞n̪t̪e	wiki
egida	ɛːd͡ʒid̪ä	wiki
egidio	ed͡ʒiːd̪jo	wiki
egilio	ed͡ʒiːl̺jo	wiki
egisto	ed͡ʒis̪t̪o	wiki
egitto	ed͡ʒit̪t̪o	wiki
egittologia	ed͡ʒit̪t̪ol̺od͡ʒiːä	wiki
egittologico	ed͡ʒit̪t̪ol̺ɔːd͡ʒiko	wiki
egittologo	ed͡ʒit̪t̪ɔːl̺oɡo	wiki
egiziaco	ed͡ʒit̪t̪͡s̪iːäko̞	wiki
egiziano	ed͡ʒit̪t̪͡s̪jäːn̺o̞	wiki
egizio	edʒit̪͡ːs̪jo	wiki
egli	eʎi	wiki
eglino	eʎʎin̺o	wiki
egloga	ɛːɡl̺oɡä	wiki
egualizzare	eɡwäl̺id̪d̪͡z̪äːr̺e̞	wiki
einsteinio	äi̯n̪s̪t̪äi̯n̺jo	wiki
el	el̺	wiki
elaboratore	elaboratore	wiki
elastoplastico	el̺äs̪t̪o̞pl̺äs̪t̪iko	wiki
elefante	el̺efän̪t̪e̞	wiki
elefantino	el̺efän̪t̪iːn̺o	wiki
eleggere	el̺ɛdd͡ʒer̺e	wiki
elettrobisturi	el̺ɛt̪t̪r̺obis̪t̪ur̺i	wiki
elettrodebole	el̺ɛt̪t̪r̺od̪eːbol̺e	wiki
elettrofiltro	el̺ɛt̪t̪r̺ofil̪t̪r̺o	wiki
elettronastia	el̺ɛt̪t̪r̺on̺äs̪t̪iä̯	wiki
elettronastia	el̺ɛt̪t̪r̺on̺äs̪t̪iːä	wiki
elettronastico	el̺ɛt̪t̪r̺on̺äs̪t̪iko	wiki
elicoide	el̺ikɔi̯d̪e	wiki
elio	ɛl̺jo	wiki
elio	ɛːl̺jo	wiki
elisabetta	elizäbet̪ːä	wiki
elisabetta	elizäbɛt̪ːä	wiki
ella	el̺l̺ä	wiki
elle	el̺l̺e	wiki
elle	ɛl̺l̺e	wiki
elleno	el̺l̺en̺o	wiki
elleno	el̺l̺ɛːn̺o	wiki
elli	el̺l̺i	wiki
ellino	el̺ːin̺o	wiki
ello	el̺l̺o	wiki
eloquente	el̺okwɛn̪t̪e	wiki
eloquentemente	el̺okwen̪t̪emen̪t̪e	wiki
eloquenza	el̺okwɛn̪t̪͡s̪ä	wiki
eloquio	el̺ɔːkwjo	wiki
elsa	el̪s̪ä	wiki
eluditrice	el̺ud̪it̪r̺iːt͡ʃe	wiki
eluire	el̺uiːr̺e	wiki
eluire	el̺wiːr̺e	wiki
elzeviro	el̺d̪͡z̪eviːr̺o	wiki
ematoide	emät̪ɔi̯d̪e	wiki
eme	ɛːme	wiki
emicrania	emikr̺äːn̺jä	wiki
emisferio	emis̪fɛːr̺jo	wiki
emisperio	emis̪pɛːr̺jo	wiki
emispero	emis̪pɛːr̺o	wiki
emme	ɛmme	wiki
emoterapia	ɛmot̪er̺äpiːä	wiki
emulare	emul̺aːr̺e	wiki
emulatore	emul̺at̪oːr̺e	wiki
emulatrice	emul̺at̪riːt͡ʃe	wiki
emulo	ɛːmul̺o	wiki
encomiastico	eŋkomjäs̪t̪iko	wiki
enne	ɛn̺n̺e	wiki
enrico	en̺r̺iːko	wiki
enrosadira	en̺r̺oz̪äd̪iːr̺ä	wiki
entelechia	en̪t̪el̺ek̟iːä	wiki
entrare	en̪t̪r̺är̺e̞	wiki
entrata	en̪t̪r̺äːt̪ä	wiki
enzima	en̪d̪͡z̪iːmä	wiki
enzimatico	en̪d̪͡z̪imäːt̪iko	wiki
enzimologo	en̪d̪͡z̪imɔːl̺oɡo	wiki
enzimopatia	en̪d̪͡z̪imopät̪iːä	wiki
enzimopenia	en̪d̪͡z̪imopen̺iːä	wiki
eo	eːo	wiki
epentetico	epen̪t̪ɛːt̪iko	wiki
epiblastico	epibl̺äs̪t̪iko	wiki
epicamente	epikäme̞n̪t̪e	wiki
epicità	epit͡ʃit̪ä	wiki
epico	ɛːpiko	wiki
epifania	epifäniːä	wiki
epifania	epifäːnjä	wiki
epifonema	epifon̺ɛːmä	wiki
epiglottale	epiɡl̺ot̪t̪äːl̺e̞	wiki
epiglottidale	epiɡl̺ɔt̪t̪id̪äːl̺e̞	wiki
epiglottide	epiɡl̺ɔt̪t̪id̪e	wiki
epimedio	epimɛːd̪jo	wiki
episcopale	epis̪kopäːl̺e̞	wiki
epitaffio	epit̪äffjo	wiki
epitafio	epit̪äːfjo	wiki
epitesi	epiːt̪ez̪i	wiki
epodo	epɔːd̪o	wiki
epopea	epopɛːä	wiki
epopeia	epopɛːjä	wiki
epoptea	epopt̪ɛːa	wiki
epopteia	epopt̪ɛːja	wiki
epoptia	epopt̪iːa	wiki
epoptica	epɔpt̪ikä	wiki
epoptico	epɔpt̪iko	wiki
epopto	epɔpt̪o	wiki
epos	ɛːpos̪	wiki
epulide	epuːl̺id̪e	wiki
epulone	epul̺oːn̺e	wiki
epulonesco	epul̺on̺es̪ko	wiki
equalizzare	ekwäl̺id̪d̪͡z̪äːr̺e̞	wiki
equalizzatore	ekwäl̺id̪d̪͡z̪ät̪o̞ːr̺e	wiki
equalizzazione	ekwäl̺id̪d̪͡z̪ät̪t̪͡s̪joːn̺e	wiki
equanime	ekwäːn̺ime	wiki
equanimità	ekwän̺imit̪ä	wiki
equilatero	ekwil̺aːt̪er̺o	wiki
equisono	ekwiːs̪on̺o	wiki
equivocare	ekwivokäːr̺e̞	wiki
equivoco	ekwiːvoko	wiki
equoreo	ekwɔːr̺e̯o	wiki
eracleo	er̺äkl̺ɛːo	wiki
eracliteo	er̺äkl̺it̪ɛːo	wiki
erba	ɛrba	wiki
erbale	er̺bäːl̺e̞	wiki
erbatico	er̺bäːt̪iko	wiki
erborinato	er̺bor̺in̺äːt̪o	wiki
erculeo	er̺kuːl̺eo	wiki
erculeo	er̺kuːl̺e̯o	wiki
eremitico	er̺emiːt̪iko	wiki
eresiologia	er̺ez̪jol̺od͡ʒiːä	wiki
ergastoplasma	er̺ɡäs̪t̪o̞pläz̪mä	wiki
eritroblastico	er̺it̪r̺obl̺äs̪t̪iko	wiki
ermo	er̺mo	wiki
ermo	ɛr̺mo	wiki
ero	ɛːr̺o	wiki
eroso	er̺oːz̪o	wiki
erre	ɛr̺r̺e	wiki
errico	er̺r̺iːko	wiki
erzegovese	er̺t̪͡s̪eɡoves̪e	wiki
erzegovese	er̺t̪͡s̪eɡovez̪e	wiki
erzegovina	er̺d̪͡z̪eɡɔːvin̺ä	wiki
erzegovina	er̺t̪͡s̪eɡɔːvin̺ä	wiki
esagono	ez̪aːɡon̺o	wiki
esarchia	ez̪är̺k̟iːä	wiki
esautorare	ez̪äu̯t̪or̺äːr̺e̞	wiki
esborso	ez̪bor̺s̪o	wiki
eschia	ɛs̪kjä	wiki
eschio	ɛs̪kjo	wiki
esculento	es̪kul̺ɛn̪t̪o	wiki
eseguire	ez̪eɡwiːr̺e	wiki
esempio	ez̪ɛmpjo	wiki
esemplo	ez̪ɛmpl̺o	wiki
esequie	ez̪ɛːkwje	wiki
esistenzialismi	ezistentsjalismi	wiki
esistenzialismi	ezistentsjalizmi	wiki
esistenzialismo	ezistentsjalismo	wiki
esistenzialismo	ezistentsjalizmo	wiki
esistere	ez̪is̪t̪er̺e	wiki
esiziale	ez̪it̪͡s̪jäːl̺e̞	wiki
esizio	ez̪it̪͡ːs̪jo	wiki
esoso	ez̪ɔːz̪o	wiki
espatriare	es̪pät̪r̺jäːr̺e̞	wiki
esperienza	es̪per̺jɛn̪t̪͡s̪ä	wiki
esperienziale	es̪per̺jen̪t̪͡s̪jäːl̺e̞	wiki
esplorazione	esplorät̪͡s̪joːne	wiki
esplosione	es̪pl̺oz̪joːn̺e	wiki
esposito	es̪pɔːz̪it̪o	wiki
esprobrare	es̪pr̺obr̺äːr̺e̞	wiki
esse	es̪ːe	wiki
esse	ɛs̪ːe	wiki
essempio	es̪s̪ɛmpjo	wiki
essemplo	es̪s̪ɛmpl̺o	wiki
essempro	es̪s̪ɛmpr̺o	wiki
essere	ɛs̪s̪er̺e	wiki
estate	es̪t̪äːt̪e̞	wiki
esto	es̪t̪o	wiki
esubero	ez̪uːber̺o	wiki
etade	et̪äːd̪e̞	wiki
etate	et̪äːt̪e̞	wiki
etcì	et͡ːʃi	wiki
etere	ɛːt̪er̺e	wiki
eteri	et̪ɛːr̺i	wiki
eteri	ɛːt̪er̺i	wiki
eternale	et̪er̺n̺äːl̺e̞	wiki
eternalmente	et̪er̺n̺äl̺me̞n̪t̪e	wiki
eterno	et̪ɛr̺n̺o	wiki
etero	et̪ɛːr̺o	wiki
etero	ɛːt̪er̺o	wiki
eteroplastica	ɛt̪er̺opl̺äs̪t̪ikä	wiki
eteroplastico	ɛt̪er̺opl̺äs̪t̪iko	wiki
etra	ɛːt̪r̺ä	wiki
etruria	et̪r̺uːr̺jä	wiki
etruscheria	et̪r̺us̪k̟er̺iːä	wiki
etrusco	et̪͡r̺us̪ko	wiki
ettagono	et̪t̪aːɡon̺o	wiki
ettagono	ɛt̪t̪aːɡon̺o	wiki
etternale	et̪t̪er̺n̺äːl̺e̞	wiki
etterno	et̪t̪ɛr̺n̺o	wiki
età	et̪ä	wiki
euclideo	eu̯kl̺id̪ɛːo	wiki
eufemismo	eufemizmo	wiki
eufemisticamente	eufemistikamente	wiki
eufemistico	eufemistiko	wiki
euglena	eu̯ɡl̺ɛːn̺ä	wiki
euro	ɛu̯r̺o	wiki
europa	eu̯rɔːpa	wiki
eurozona	ɛu̯r̺od̪͡z̪ɔːn̺ä	wiki
evitazione	evit̪ät̪t̪͡s̪joːn̺e	wiki
evo	ɛːvo	wiki
evocare	evokäːr̺e̞	wiki
evocazione	evokät̪͡s̪joːn̺e	wiki
exempio	eks̪ɛmpjo	wiki
exeresi	eks̪ɛːr̺ez̪i	wiki
extispicio	eks̪t̪is̪piːt͡ʃo	wiki
eziandio	et̪͡ːs̪jän̪d̪iːo	wiki
fa	fa	wiki
fabbro	fäbbr̺o	wiki
fabrizio	fäbr̺it̪͡ːs̪jo	wiki
fabro	fäːbr̺o	wiki
fabulare	fäbul̺äːr̺e̞	wiki
facciamo	fattʃaːmo	wiki
faccio	fät͡ːʃo	wiki
faccitergio	fätt͡ʃit̪ɛr̺d͡ʒo	wiki
facevano	fatʃeːvano	wiki
fachiro	fäk̟iːr̺o	wiki
faggio	fäd͡ːʒo̞	wiki
fagiana	fäd͡ʒäːn̺ä	wiki
fagianaia	fäd͡ʒän̺äːjä	wiki
fagiano	fäd͡ʒäːn̺o̞	wiki
fagiolo	fäd͡ʒɔːl̺o	wiki
falanghina	fäläŋɡ̟iːnä	wiki
falbo	fäl̺bo̞	wiki
fallo	fäl̺l̺o̞	wiki
fame	faːme	wiki
famulo	fäːmul̺o	wiki
fandango	fän̪d̪äŋɡo̞	wiki
fanno	fanno	wiki
fantasie	fän̪ːt̪äziːe	wiki
faraone	fär̺äoːn̺e	wiki
farcia	fär̺t͡ʃä	wiki
farcire	fär̺t͡ʃiːr̺e	wiki
fare	faːre	wiki
farfalla	fär̺fäl̺l̺ä	wiki
farmacologicamente	far̺mako̞l̺od͡ʒikame̞n̪t̪e	wiki
farmacologico	far̺mako̞l̺ɔːd͡ʒiko	wiki
farnetto	fär̺n̺e̞t̪t̪o	wiki
farragine	fär̺r̺äːdʒin̺e	wiki
farsi	fär̺s̪i	wiki
fascinaia	fäʃʃin̺äːjä	wiki
fascinaio	fäʃʃin̺äːjo	wiki
fascio	fäʃʃo̞	wiki
fascista	fäʃʃis̪t̪ä	wiki
fatamorgana	fät̪ämorɡäːnä	wiki
fate	faːt̪e	wiki
fatica	fät̪iːkä	wiki
fatico	fäːt̪iko	wiki
fatterello	fät̪t̪e̞r̺ɛl̺l̺o	wiki
fatto	fät̚t̪o̞	wiki
fattona	fät̪ːo̞ːn̺ä	wiki
fattone	fät̪t̪o̞ːn̺e	wiki
fatwa	fäːt̪wä	wiki
favella	fävɛl̺l̺ä	wiki
favellare	fäve̞l̺l̺äːr̺e̞	wiki
favellatore	fäve̞l̺l̺ät̪o̞ːr̺e	wiki
favellatrice	fäve̞l̺l̺ät̪r̺iːt͡ʃe	wiki
favonio	fävɔːn̺jo	wiki
febbraio	febbr̺äːjo	wiki
fecero	feːtʃero	wiki
feda	fɛːd̪ä	wiki
fedai	fed̪äi̯	wiki
fedammo	fed̪ämmo̞	wiki
fedano	fɛːd̪än̺o̞	wiki
fedare	fed̪äːr̺e̞	wiki
fedarono	fed̪äːr̺o̞n̺o	wiki
fedasse	fed̪äs̪s̪e̞	wiki
fedassero	fed̪äs̪s̪e̞r̺o	wiki
fedassi	fed̪äs̪s̪i	wiki
fedassimo	fed̪äs̪s̪imo	wiki
fedaste	fed̪äs̪t̪e̞	wiki
fedasti	fed̪äs̪t̪i	wiki
fedate	fed̪äːt̪e̞	wiki
fedava	fed̪äːvä	wiki
fedavamo	fed̪äväːmo̞	wiki
fedavano	fed̪äːvän̺o̞	wiki
fedavate	fed̪äväːt̪e̞	wiki
fedavi	fed̪äːvi	wiki
fedavo	fed̪äːvo̞	wiki
fede	feːd̪e	wiki
fede	fɛːd̪e	wiki
fedele	fed̪eːl̺e	wiki
fedelmente	fed̪el̺men̪t̪e	wiki
fedeltà	fed̪el̺t̪ä	wiki
federai	fed̪er̺äi̯	wiki
federale	fed̪er̺äːl̺e̞	wiki
federalismo	fed̪er̺äl̺iz̪mo	wiki
federalista	fed̪er̺äl̺is̪t̪ä	wiki
federalistico	fed̪er̺äl̺is̪t̪iko	wiki
federalmente	fed̪er̺äl̺me̞n̪t̪e	wiki
federanno	fed̪er̺än̺n̺o̞	wiki
federare	fed̪er̺äːr̺e̞	wiki
federarsi	fed̪er̺är̺s̪i	wiki
federativo	fed̪er̺ät̪iːvo	wiki
federato	fed̪er̺äːt̪o̞	wiki
federazione	fed̪er̺ät̪t͡sjoːn̺e̞	wiki
federebbe	fed̪er̺ebbe	wiki
federebbero	fed̪er̺ebber̺o	wiki
federei	fed̪er̺ɛi̯	wiki
federemmo	fed̪er̺emmo	wiki
federemo	fed̪er̺eːmo	wiki
federeste	fed̪er̺es̪t̪e	wiki
federesti	fed̪er̺es̪t̪i	wiki
federete	fed̪er̺eːt̪e	wiki
federico	fed̪er̺iːko	wiki
federigo	fed̪er̺iːɡo	wiki
federà	fed̪er̺ä	wiki
federò	fed̪er̺ɔ	wiki
fedi	feːd̪i	wiki
fedi	fɛːd̪i	wiki
fediamo	fed̪jäːmo̞	wiki
fediate	fed̪jäːt̪e̞	wiki
fedifrago	fed̪iːfr̺äɡo̞	wiki
fedino	fɛːd̪in̺o	wiki
fedo	fɛːd̪o	wiki
fedrico	fed̪r̺iːko	wiki
fedò	fed̪ɔ	wiki
fegato	feɡato	wiki
feldmaresciallo	fɛl̺d̪mär̺eʃːäl̺ːo	wiki
fendere	fɛndere	wiki
fenicio	fen̺iːt͡ʃo	wiki
fermaporta	fer̺mäpɔr̺t̪ä	wiki
fermauscio	fer̺mäuʃʃo	wiki
fermio	fer̺mjo	wiki
fero	fɛːr̺o	wiki
feroico	fer̺ɔi̯ko	wiki
ferreo	fɛr̺r̺eo	wiki
ferreo	fɛr̺r̺eo̯	wiki
ferrigno	fer̺r̺iɲɲo	wiki
fervere	fɛr̺ver̺e	wiki
fescennino	feʃʃen̺n̺iːn̺o	wiki
fessacchiotto	fes̪s̪äkk̟jɔt̪t̪o	wiki
fesso	fes̪s̪o	wiki
festa	fɛs̪t̪ä	wiki
festeggiare	fes̪t̪edd͡ʒäːr̺e̞	wiki
festuca	fes̪t̪uːkä	wiki
fettunta	fet̪ːun̪t̪ä	wiki
fiacca	fjäkːä	wiki
fiaccare	fjäkːäːr̺e̞	wiki
fiacco	fjäkːo̞	wiki
fiamma	fjämmä	wiki
fiammare	fjämmäːr̺e̞	wiki
fiammata	fjämmäːt̪ä	wiki
fiasco	fjäs̪ːko	wiki
fiata	fjaːt̪a	wiki
fibroblastico	fibr̺obl̺äs̪t̪iko	wiki
fibroelastico	fibr̺oel̺äs̪t̪iko	wiki
fibroplastico	fibr̺opl̺äs̪t̪iko	wiki
fida	fiːd̪ä	wiki
fidanza	fid̪än̪t̪͡s̪ä	wiki
fidanzamento	fid̪än̪t̪͡s̪äme̞n̪t̪o	wiki
fidanzare	fid̪än̪t̪͡s̪äːr̺e̞	wiki
fidanzarsi	fid̪än̪t̪͡s̪är̺s̪i	wiki
fidanzata	fid̪än̪t̪͡s̪äːt̪ä	wiki
fidare	fid̪äːr̺e̞	wiki
fidarsi	fid̪är̺s̪i	wiki
fidatamente	fid̪ät̪äme̞n̪t̪e	wiki
fidato	fid̪äːt̪o̞	wiki
fideismo	fid̪e̯iz̪mo	wiki
fideista	fid̪e̯is̪t̪ä	wiki
fideisticamente	fid̪e̯is̪t̪ikäme̞n̪t̪e	wiki
fideistico	fid̪e̯is̪t̪iko	wiki
fideiussione	fid̪ejus̪s̪joːn̺e	wiki
fideiussore	fid̪ejus̪s̪oːr̺e	wiki
fideiussorio	fid̪ejus̪s̪ɔːr̺jo	wiki
fidele	fid̪eːl̺e	wiki
fidelità	fid̪el̺it̪ä	wiki
fidelizzare	fid̪el̺id̪̪d͡z̪äːr̺e̞	wiki
fidelizzazione	fid̪el̺id̪d̪͡z̪ät̪t̪͡s̪joːn̺e	wiki
fidicina	fid̪iːt͡ʃin̺ä	wiki
fidicine	fid̪iːt͡ʃin̺e	wiki
fido	fiːd̪o	wiki
fiducia	fid̪uːt͡ʃä	wiki
fiduciante	fid̪ut͡ʃän̪t̪e̞	wiki
fiduciaria	fid̪ut͡ʃäːr̺jä	wiki
fiduciario	fid̪ut͡ʃäːr̺jo	wiki
fiduciosamente	fid̪ut͡ʃoz̪äme̞n̪t̪e	wiki
fiducioso	fid̪ut͡ʃoːz̪o	wiki
fiero	fjɛːr̺o	wiki
fievole	fjɛːvol̺e	wiki
figlia	fiʎːä	wiki
figlio	fiʎːo	wiki
figliolo	fiʎːɔ̟ːlo	wiki
figliuolo	fiʎːwɔ̟ːlo	wiki
figurati	fiɡurati	wiki
filanca	fil̺äŋkä	wiki
filibustiere	fil̺ibus̪t̪jɛːr̺e	wiki
fillo	fil̺l̺o	wiki
filosofa	filɔːzofa	wiki
filosofale	fil̺oz̪ofäːl̺e̞	wiki
filosofastro	fil̺oz̪ofäs̪t̪r̺o̞	wiki
filosofe	filɔːzofe	wiki
filosofeggiare	fil̺oz̪ofedd͡ʒäːr̺e̞	wiki
filosoferia	fil̺oz̪ofer̺iä̯	wiki
filosoferia	fil̺oz̪ofer̺iːä	wiki
filosofi	filɔːzofi	wiki
filosofo	fil̺ɔːz̪ofo	wiki
fimo	fiːmo	wiki
finale	finäːle	wiki
finestra	finɛːst̪ra	wiki
finlandese	fin̺l̺än̪d̪e̞ːz̪e	wiki
finno	fin̺n̺o	wiki
fintantoché	fin̪t̪än̪t̪o̞k̟e	wiki
fionchetto	fjoŋk̟et̪t̪o	wiki
fionco	fjoŋko	wiki
fiordo	fjɔr̺d̪o	wiki
fire	fiːr̺e	wiki
fisico	fiːz̪iko	wiki
fisicoteologia	fiz̪ikot̪eo̯l̺od͡ʒiä̯	wiki
fisicoteologico	fiz̪ikot̪eo̯l̺ɔːd͡ʒiko	wiki
fiumana	fjumäːnä	wiki
fiumano	fjumäːno	wiki
fiume	fjuːme	wiki
flaubertiano	flobert̪jäːno	wiki
flavedine	fl̺ävɛːd̪in̺e	wiki
flavedo	fl̺ävɛːd̪o	wiki
flavescente	fl̺äve̞ʃʃɛn̪t̪e	wiki
flavismo	fl̺äviz̪mo	wiki
flavizie	fl̺ävit̪t̪͡s̪je	wiki
flavo	fl̺äːvo̞	wiki
flavoxantina	fl̺ävo̞ks̪än̪t̪iːn̺ä	wiki
flebile	fl̺ɛːbil̺e	wiki
florilegio	fl̺or̺il̺ɛːd͡ʒo	wiki
fluire	fluire	wiki
fluoro	fl̺uɔːr̺o	wiki
fluoro	fl̺wɔːr̺o	wiki
foberismo	fober̺iz̪mo	wiki
fobia	fobiä̯	wiki
fobo	fɔːbo	wiki
fobos	fɔːbos̪	wiki
foca	fɔːkä	wiki
focherello	foker̺ɛl̺l̺o	wiki
foci	foːtʃi	wiki
foco	fɔːko	wiki
focus	fɔːkus̪	wiki
fognare	foɲɲäːr̺e̞	wiki
fogno	foɲɲo	wiki
fola	fɔːla	wiki
folgorare	fol̺ɡor̺äːr̺e̞	wiki
folgore	fol̺ɡor̺e	wiki
folgore	fol̺ɡoːr̺e	wiki
fonograficamente	fon̺oɡr̺äfikäme̞n̪t̪e	wiki
fonografico	fon̺oɡr̺äːfiko	wiki
fonografo	fon̺ɔːɡr̺äfo̞	wiki
fonologia	fon̺ol̺od͡ʒiä̯	wiki
fonoriproduttore	fɔn̺or̺ipr̺od̪ut̪t̪oːr̺e	wiki
fonosemantica	fon̺os̪emän̪t̪ikä	wiki
fonosemantico	fon̺os̪emän̪t̪iko	wiki
fonosimbolo	fon̺os̪imbol̺o	wiki
foracchiare	for̺äkk̟jäːr̺e̞	wiki
foracchiato	for̺äkk̟jäːt̪o̞	wiki
foracchiatura	for̺äkk̟jät̪uːr̺ä	wiki
forchetta	fork̟et̪ːä	wiki
forgia	fɔr̺d͡ʒä	wiki
formaggio	formad̪̚d̪͡ʒo	wiki
formica	for̺miːkä	wiki
formica	fɔr̺mikä	wiki
formicaio	for̺mikäːjo̞	wiki
formichetta	for̺mik̟et̪t̪ä	wiki
formichina	for̺mik̟iːn̺ä	wiki
formico	fɔr̺miko	wiki
formicola	for̺miːkol̺ä	wiki
formicolamento	for̺mikol̺äme̞n̪t̪o	wiki
formicolare	for̺mikol̺äːr̺e̞	wiki
formicolio	for̺mikol̺io̯	wiki
foro	foːr̺o	wiki
foro	fɔːr̺o	wiki
fortalizio	for̺t̪äl̺it̪͡ːs̪jo	wiki
fortilizio	for̺t̪il̺it̪͡ːs̪jo	wiki
fortuna	fort̪uːna	wiki
fortune	fort̪uːne	wiki
forum	fɔːr̺um	wiki
forza	fɔr̺t̪͡s̪ä	wiki
foschia	foskia	wiki
fosforo	fɔsfor̺o	wiki
fosse	fos̪ːe	wiki
fosse	fɔs̪ːe	wiki
fossi	fos̪s̪i	wiki
fossi	fɔs̪s̪i	wiki
fotoblastico	fot̪obl̺äs̪t̪iko	wiki
fotoelastico	fɔt̪oel̺äs̪t̪iko	wiki
fotogenia	fot̪od͡ʒen̺iä̯	wiki
fotogenicità	fot̪od͡ʒen̺it͡ʃit̪ä	wiki
fotogenico	fot̪od͡ʒɛːn̺iko	wiki
fottere	fot̪t̪er̺e	wiki
fottivento	fot̪t̪ivɛn̪t̪o	wiki
fracasso	fr̺äkäs̪ːo	wiki
fragno	fr̺äɲɲo̞	wiki
fraile	fräi̯l̺e	wiki
francesca	frän̠ʲt͡ʃeskä	wiki
francesco	fr̺än̺ʲt͡ʃe̞s̪ko	wiki
francio	frän̠ʲːt͡ʃo	wiki
franciosa	fr̺än̺ʲt͡ʃo̞ːz̪ä	wiki
francioso	fr̺än̺ʲt͡ʃo̞ːz̪o	wiki
fratelli	fratɛlli	wiki
fratello	frat̪ɛllo	wiki
fraticello	fr̺ät̪it͡ʃɛl̺l̺o	wiki
fratta	fr̺ät̪t̪ä	wiki
frazionabile	fr̺at̪͡s̪i̯on̺aːbil̺e	wiki
frazionabilità	fr̺at̪͡s̪i̯on̺abil̺it̪a	wiki
frazione	fr̺ät̪͡ːs̪joːn̺e	wiki
freccia	fr̺ett͡ʃä	wiki
frederico	fr̺ed̪er̺iːko	wiki
frenesia	fr̺en̺ez̪iːä	wiki
fricativa	fr̺ikät̪iːvä	wiki
fricativo	fr̺ikät̪iːvo	wiki
frinire	fr̺in̺iːr̺e	wiki
frontale	front̪aːle	wiki
fronte	front̪e	wiki
frusta	fr̺us̪t̪ä	wiki
frustare	fr̺us̪t̪äːr̺e̞	wiki
frusto	fr̺us̪t̪o	wiki
frustra	fr̺us̪t̪r̺ä	wiki
frustraneità	fr̺us̪t̪r̺än̺ei̯t̪ä	wiki
frustraneo	fr̺us̪t̪r̺äːn̺e̯o	wiki
frustrante	fr̺us̪t̪r̺än̪t̪e̞	wiki
frustrare	fr̺us̪t̪r̺äːr̺e̞	wiki
frustrato	fr̺us̪t̪r̺äːt̪o	wiki
frustrazione	fr̺us̪t̪r̺ät̪t̪͡s̪joːn̺e	wiki
frutto	fr̺ut̪t̪o	wiki
fucile	fut͡ʃiːl̺e	wiki
fulgere	ful̺ʲd͡ʒer̺e	wiki
fulgido	ful̺ʲd͡ʒid̪o	wiki
fulgore	ful̺ɡoːr̺e	wiki
fulmine	ful̺min̺e	wiki
funame	fun̺äːme̞	wiki
fune	fuːn̺e	wiki
funerale	fun̺er̺äːl̺e̞	wiki
funeralone	fun̺er̺äl̺o̞ːn̺e	wiki
funerante	fun̺er̺än̪t̪e̞	wiki
funerario	fun̺er̺äːr̺jo̞	wiki
funeratizio	fun̺er̺ät̪it̪t̪͡s̪jo	wiki
funere	fuːn̺er̺e	wiki
funereo	fun̺ɛːr̺eo̯	wiki
fungere	fun̺ʲd͡ʒer̺e	wiki
fuocherello	fwoker̺ɛl̺l̺o	wiki
fuochi	fwoki	wiki
fuoco	fwɔːko	wiki
furace	fur̺äːt͡ʃe̞	wiki
furare	fur̺äːr̺e̞	wiki
furente	fur̺ɛn̪t̪e	wiki
furere	fuːr̺er̺e	wiki
furia	fuːr̺jä	wiki
furo	fuːr̺o	wiki
furto	fur̺t̪o	wiki
fusse	fus̪ːe	wiki
fusto	fus̪t̪o	wiki
futile	fuːt̪il̺e	wiki
gabardine	ɡabard̪iːne	wiki
gabba	ɡäbːä	wiki
gabbeo	ɡäbbɛːo	wiki
gabbianello	ɡäbbjän̺ɛl̺l̺o	wiki
gabbio	ɡäbːjo	wiki
gabbo	ɡäbːo̞	wiki
gaggia	ɡädd͡ʒiä̯	wiki
gaggia	ɡädd͡ʒiːä	wiki
gaggia	ɡädd͡ʒä	wiki
gaggio	ɡäd͡ːʒo̞	wiki
gaglioffo	ɡäʎʎɔffo	wiki
gala	ɡaːla	wiki
galano	ɡäläːno	wiki
galassia	ɡalassja	wiki
galassie	ɡalassje	wiki
galateo	ɡäl̺ät̪ɛːo	wiki
galattagogo	ɡäl̺ät̪ːäɡɔːɡo	wiki
galeazzo	ɡäl̺e̞ät̪t̪͡s̪o̞	wiki
galliambo	ɡäl̺l̺jämbo̞	wiki
gallicinio	ɡäl̺l̺it͡ʃiːn̺jo	wiki
gamba	ɡamba	wiki
gamberetto	ɡämbe̞r̺et̪t̪o	wiki
gambero	ɡämbe̞r̺o	wiki
gamma	ɡämmä	wiki
gang	ɡɛŋɡ	wiki
ganga	ɡäŋɡä	wiki
gangia	ɡän̺ʲd͡ʒä	wiki
garofano	ɡärɔːfän̺o̞	wiki
garzonato	ɡär̺d̪͡z̪o̞n̺äːt̪o̞	wiki
garzone	ɡär̺d̪͡z̪o̞ːn̺e	wiki
gattabuia	ɡät̪ːäbuːjä	wiki
gattaia	ɡät̪ːäːjä	wiki
gattara	ɡät̪ːäːrä	wiki
gattaro	ɡät̪ːäːro	wiki
gattinara	ɡät̪ːinäːrä	wiki
gattinarese	ɡät̪ːinäreːse	wiki
gattinarese	ɡät̪ːinäreːze	wiki
gatto	ɡat̪t̪o	wiki
gattuccio	ɡät̪t̪utt͡ʃo	wiki
gaulo	ɡäu̯l̺o	wiki
gavigliano	ɡäviʎʎäːn̺o̞	wiki
gazzarino	ɡäd̪͡z̪d̪͡z̪är̺iːn̺o	wiki
gei	d͡ʒɛi̯	wiki
gelare	dʒelare	wiki
gelatina	d͡ʒel̺ät̪iːn̺ä	wiki
gelato	d͡ʒel̺äːt̪o	wiki
gelicidio	d͡ʒel̺it͡ʃiːd̪jo	wiki
gelido	d͡ʒɛːl̺id̪o	wiki
gellaba	d͡ʒel̺l̺äːbä	wiki
gelo	d͡ʒɛːl̺o	wiki
gena	d͡ʒɛːn̺ä	wiki
gene	d͡ʒɛːn̺e	wiki
genere	d͡ʒɛːn̺er̺e	wiki
genetliaco	d͡ʒen̺et̪l̺iːäko̞	wiki
genitrice	d͡ʒen̺it̪r̺iːt͡ʃe	wiki
gennaio	d͡ʒen̺n̺äːjo	wiki
gente	d͡ʒɛn̪t̪e	wiki
geoide	d͡ʒeɔi̯d̪e	wiki
geometria	d͡ʒeometria	wiki
georgia	d͡ʒe̯ɔr̺d͡ʒä	wiki
gerarca	d͡ʒer̺är̺kä	wiki
gerfalco	d͡ʒer̺fäl̺ko̞	wiki
gergale	d͡ʒer̺ɡäːl̺e̞	wiki
gergo	d͡ʒɛr̺ɡo	wiki
germanico	d͡ʒer̺mäːn̺iko	wiki
germanizzare	d͡ʒer̺män̺id̪d̪͡z̪äːr̺e̞	wiki
germanizzazione	d͡ʒer̺män̺id̪d̪͡z̪ät̪͡s̪joːn̺e	wiki
germano	d͡ʒer̺mäːn̺o̞	wiki
germe	d͡ʒɛr̺me	wiki
germinare	d͡ʒer̺minäːr̺e̞	wiki
gesummaria	d͡ʒezumːäriːä	wiki
gesù	d͡ʒez̪u	wiki
ghenga	ɡɛŋɡä	wiki
gherone	ɡer̺oːn̺e	wiki
ghi	ɡ̟i	wiki
ghiaccia	ɡ̟jät͡ːʃä	wiki
ghiacciato	ɡ̟jätt͡ʃäːt̪o̞	wiki
ghiaccio	ɡ̟jätt͡ʃo̞	wiki
ghiacciolo	ɡ̟jätt͡ʃɔːl̺o	wiki
ghiaia	ɡ̟jäːjä	wiki
ghiaioso	ɡ̟jäjoːz̪o	wiki
ghianda	ɡ̟jän̪d̪ä	wiki
ghiara	ɡ̟jäːjä	wiki
ghiaroso	ɡ̟jär̺o̞ːz̪o	wiki
ghiazarino	ɡjäd̪͡z̪är̺iːn̺o	wiki
ghiazzerino	ɡjäd̪d̪͡z̪e̞r̺iːn̺o	wiki
ghimel	ɡ̟iːmel̺	wiki
ghinda	ɡ̟in̪d̪ä	wiki
ghindazzo	ɡ̟in̪d̪ät̪t̪͡s̪o̞	wiki
ghiomo	ɡ̟jɔːmo	wiki
ghiotto	ɡ̟jot̪ːo	wiki
ghiro	ɡ̟iːr̺o	wiki
ghironda	ɡ̟ir̺on̪d̪ä	wiki
giaculatoria	d͡ʒäkul̺ät̪ɔːr̺jä	wiki
giallo	d͡ʒälːo	wiki
giallognolo	d͡ʒälːoɲːolo	wiki
giallognolo	d͡ʒälːɔɲːolo	wiki
giammai	d͡ʒämmäi̯	wiki
gianduia	d͡ʒän̪d̪uːjä	wiki
gianduiotto	d͡ʒän̪d̪ujɔt̪ːo	wiki
gianduja	d͡ʒän̪d̪uːjä	wiki
gianicolense	d͡ʒän̺ikol̺ɛn̪s̪e	wiki
gianicolo	d͡ʒän̺iːkol̺o	wiki
gianluca	d͡ʒän̺l̺uːkä	wiki
gianmarco	d͡ʒämmär̺ko̞	wiki
giappone	d͡ʒäppoːne	wiki
giapponese	d͡ʒäppon̺eːz̪e	wiki
giapponeseria	d͡ʒäpːoneseriːä	wiki
giapponeseria	d͡ʒäpːonezeriːä	wiki
giapponesità	d͡ʒapːonesit̪ä	wiki
giapponesità	d͡ʒapːonezit̪ä	wiki
giapponio	d͡ʒäppɔːn̺jo	wiki
giardino	d͡ʒard̪iːno	wiki
giaurro	d͡ʒäur̺r̺o	wiki
giazzerino	d͡ʒäd̪͡z̪d̪͡z̪e̞r̺iːn̺o	wiki
gibassiera	d͡ʒibäs̪s̪jɛːr̺ä	wiki
gibboso	d͡ʒibboːz̪o	wiki
gibetto	d͡ʒibet̪ːo	wiki
gilberto	d͡ʒil̺bɛr̺t̪o	wiki
gillotaggio	d͡ʒil̺l̺ot̪ädd͡ʒo̞	wiki
ginevra	dʒineːvra	wiki
ginocchio	dʒinɔkkjo	wiki
giocare	d͡ʒokäːr̺e̞	wiki
gioco	d͡ʒɔːko	wiki
gioconda	d͡ʒokon̪d̪ä	wiki
giocoso	d͡ʒokoːz̪o	wiki
giogaia	d͡ʒoɡäːjä	wiki
gioia	dʒɔːjä	wiki
giolittiano	d͡ʒolit̪ːjäːno	wiki
giorgia	d͡ʒɔr̺d͡ʒä	wiki
giorgio	d͡ʒor̺d͡ʒo	wiki
giorgio	d͡ʒɔr̺d͡ʒo	wiki
giovanaglia	d͡ʒovän̺äʎʎä	wiki
giovaneggiare	d͡ʒovän̺e̞dd͡ʒäːr̺e̞	wiki
giovanesco	d͡ʒovän̺e̞s̪ko	wiki
giovanezza	d͡ʒovän̺e̞t̪t̪͡s̪ä	wiki
giovanile	d͡ʒovän̺iːl̺e	wiki
giovanni	d͡ʒovän̺n̺i	wiki
giovanotta	d͡ʒovän̺ɔt̪t̪ä	wiki
giovanotto	d͡ʒovän̺ɔt̪t̪o	wiki
giove	d͡ʒɔːve	wiki
giovedì	d͡ʒoved̪i	wiki
giovenca	d͡ʒovɛŋkä	wiki
giovenco	d͡ʒovɛŋko	wiki
giovenile	d͡ʒoven̺iːl̺e	wiki
gioventude	d͡ʒoven̪t̪uːd̪e	wiki
gioventute	d͡ʒoven̪t̪uːt̪e	wiki
gioventù	d͡ʒoven̪t̪u	wiki
giovinaccia	d͡ʒovin̺ätt͡ʃä	wiki
giovinaccio	d͡ʒovin̺ätt͡ʃo̞	wiki
giovincella	d͡ʒovin̺ʲt͡ʃɛl̺l̺ä	wiki
giovincello	d͡ʒovin̺ʲt͡ʃɛl̺l̺o	wiki
giovine	d͡ʒoːvin̺e	wiki
giovinezza	d͡ʒovin̺et̪t̪͡s̪ä	wiki
giovinotta	d͡ʒovin̺ɔt̪t̪ä	wiki
giovinotto	d͡ʒovin̺ɔt̪t̪o	wiki
giravoltare	d͡ʒir̺ävo̞l̪t̪äːr̺e̞	wiki
gire	d͡ʒiːr̺e	wiki
girfalco	d͡ʒir̺fäl̺ko̞	wiki
girifalco	d͡ʒir̺ifäl̺ko̞	wiki
gironda	d͡ʒir̺on̪d̪ä	wiki
gisarma	d͡ʒiz̪är̺mä	wiki
giucare	d͡ʒukäːr̺e̞	wiki
giudaico	d͡ʒud̪äi̯ko	wiki
giudaismo	d͡ʒud̪äiz̪mo	wiki
giudicabile	d͡ʒud̪ikäːbil̺e	wiki
giudicabilità	d͡ʒud̪ikäbil̺it̪ä	wiki
giudicale	d͡ʒud̪ikäːl̺e	wiki
giudicamento	d͡ʒud̪ikäme̞n̪t̪o	wiki
giudicante	d͡ʒud̪ikän̪t̪e̞	wiki
giudicare	d͡ʒud̪ikäːr̺e̞	wiki
giudicativo	d͡ʒud̪ikät̪iːvo	wiki
giudicato	d͡ʒud̪ikäːt̪o̞	wiki
giudicatore	d͡ʒud̪ikät̪o̞ːr̺e	wiki
giudicatori	d͡ʒud̪ikät̪o̞ːr̺i	wiki
giudicatori	d͡ʒud̪ikät̪ɔːr̺i	wiki
giudicatorio	d͡ʒud̪ikät̪ɔːr̺jo	wiki
giudicatrice	d͡ʒud̪ikät̪r̺iːt͡ʃe	wiki
giudicatura	d͡ʒud̪ikät̪uːr̺ä	wiki
giudice	d͡ʒuːd̪it͡ʃe	wiki
giudici	d͡ʒud̪iːt͡ʃi	wiki
giudici	d͡ʒuːd̪it͡ʃi	wiki
giudicio	d͡ʒud̪iːt͡ʃo	wiki
giudiziale	d͡ʒud̪it̪t̪͡s̪jäl̺e̞	wiki
giudizialmente	d͡ʒud̪it̪t̪͡s̪jäl̺me̞n̪t̪e	wiki
giudiziariamente	d͡ʒud̪it̪t̪͡s̪jär̺jäme̞n̪t̪e	wiki
giudiziario	d͡ʒud̪it̪t̪͡s̪jäːr̺jo	wiki
giudizio	d͡ʒud̪it̪t̪͡s̪jo	wiki
giudiziosamente	d͡ʒud̪it̪t̪͡s̪joz̪äme̞n̪t̪e	wiki
giudizioso	d͡ʒud̪it̪t̪͡s̪joːz̪o	wiki
giugno	d͡ʒuɲːo	wiki
giulio	d͡ʒuːl̺jo	wiki
giullare	d͡ʒul̺l̺äːr̺e̞	wiki
giullaresco	d͡ʒul̺l̺är̺e̞s̪ko	wiki
giungere	d͡ʒun̺ʲd͡ʒer̺e	wiki
giungimento	d͡ʒun̺ʲd͡ʒimen̪t̪o	wiki
giuocare	d͡ʒwokäːr̺e̞	wiki
giuoco	d͡ʒwɔːko	wiki
giura	d͡ʒuːr̺ä	wiki
giurabbacco	d͡ʒur̺äbbäkko̞	wiki
giurabile	d͡ʒur̺äːbil̺e	wiki
giuracchiare	d͡ʒur̺äkk̟jäːr̺e̞	wiki
giuraddiana	d͡ʒur̺äd̪d̪jäːn̺ä	wiki
giuraddio	d͡ʒur̺äd̪d̪io̯	wiki
giuramento	d͡ʒur̺äme̞n̪t̪o	wiki
giurare	d͡ʒur̺äːr̺e̞	wiki
giurativo	d͡ʒur̺ät̪iːvo	wiki
giuratorio	d͡ʒur̺ät̪ɔːr̺jo	wiki
giure	d͡ʒuːr̺e	wiki
giureconsulto	d͡ʒur̺ekon̪s̪ul̪t̪o	wiki
giuria	d͡ʒur̺iä̯	wiki
giuridicamente	d͡ʒur̺id̪ikäme̞n̪t̪e	wiki
giuridicità	d͡ʒur̺id̪it͡ʃit̪ä	wiki
giuridico	d͡ʒur̺iːd̪iko	wiki
giurisdicente	d͡ʒur̺iz̪d̪it͡ʃɛn̪t̪e	wiki
giurisdizionale	d͡ʒur̺iz̪d̪it̪t̪͡s̪jon̺äːl̺e̞	wiki
giurisdizionalismo	d͡ʒur̺iz̪d̪it̪t̪͡s̪jon̺äl̺iz̪mo	wiki
giurisdizionalista	d͡ʒur̺iz̪d̪it̪t̪͡s̪jon̺äl̺is̪t̪ä	wiki
giurisdizionalistico	d͡ʒur̺iz̪d̪it̪t̪͡s̪jon̺äl̺is̪t̪iko	wiki
giurisdizionalità	d͡ʒur̺iz̪d̪it̪t̪͡s̪jon̺äl̺it̪ä	wiki
giurisdizionalizzazione	d͡ʒur̺iz̪d̪it̪t̪͡s̪jon̺äl̺id̪d̪͡z̪ät̪t̪͡s̪joːn̺e	wiki
giurisdizionalmente	d͡ʒur̺iz̪d̪it̪t̪͡s̪jon̺äl̺me̞n̪t̪e	wiki
giurisdizione	d͡ʒur̺iz̪d̪it̪t̪͡s̪joːn̺e	wiki
giurisperito	d͡ʒur̺is̪per̺iːt̪o	wiki
giurisprudente	d͡ʒur̺is̪pr̺ud̪ɛn̪t̪e	wiki
giurisprudenza	d͡ʒur̺is̪pr̺ud̪ɛn̪t̪͡s̪ä	wiki
giurisprudenziale	d͡ʒur̺is̪pr̺ud̪en̪t̪͡s̪jäːl̺e̞	wiki
giurista	d͡ʒur̺is̪t̪ä	wiki
giuristico	d͡ʒur̺is̪t̪iko	wiki
giurì	d͡ʒur̺i	wiki
gius	d͡ʒus̪	wiki
giusarma	d͡ʒuz̪är̺mä	wiki
giuscanonista	d͡ʒus̪kän̺o̞n̺is̪t̪ä	wiki
giuscibernetica	d͡ʒus̪t͡ʃiber̺n̺ɛːt̪ikä	wiki
giuscibernetico	d͡ʒus̪t͡ʃiber̺n̺ɛːt̪iko	wiki
giuscivilista	d͡ʒus̪t͡ʃivil̺is̪t̪ä	wiki
giusdicente	d͡ʒuz̪d̪it͡ʃɛn̪t̪e	wiki
giuseppe	d͡ʒuz̪ɛppe	wiki
giuslavorista	d͡ʒuz̪l̺ävo̞r̺is̪t̪ä	wiki
giusnaturalismo	d͡ʒuz̪n̺ät̪ur̺äl̺iz̪mo	wiki
giusnaturalista	d͡ʒuz̪n̺ät̪ur̺äl̺is̪t̪ä	wiki
giusnaturalistico	d͡ʒuz̪n̺ät̪ur̺äl̺is̪t̪iko	wiki
giuso	d͡ʒuːz̪o	wiki
giuspatronato	d͡ʒus̪pat̪r̺on̺äːt̪o̞	wiki
giuspositivismo	d͡ʒus̪poz̪it̪iviz̪mo	wiki
giusrealismo	d͡ʒuz̪r̺eä̯l̺iz̪mo	wiki
giustacore	d͡ʒus̪t̪äkɔːr̺e	wiki
giustacorpo	d͡ʒus̪t̪äkɔr̺po	wiki
giustacuore	d͡ʒus̪t̪äkwɔːr̺e	wiki
giustamente	d͡ʒus̪t̪äme̞n̪t̪e	wiki
giustapporre	d͡ʒus̪t̪äppo̞r̺r̺e	wiki
giustapporsi	d͡ʒus̪t̪äppo̞r̺s̪i	wiki
giustapposizione	d͡ʒus̪t̪äppo̞z̪it̪t̪͡s̪joːn̺e	wiki
giustapposto	d͡ʒus̪t̪äppo̞s̪t̪o	wiki
giustappunto	d͡ʒus̪t̪äppun̪t̪o	wiki
giustezza	d͡ʒus̪t̪et̪͡ːs̪ä	wiki
giustificabile	d͡ʒus̪t̪ifikäːbil̺e	wiki
giustificabilità	d͡ʒus̪t̪ifikäbil̺it̪ä	wiki
giustificabilmente	d͡ʒus̪t̪ifikäbil̺men̪t̪e	wiki
giustificare	d͡ʒus̪t̪ifikäːr̺e̞	wiki
giustificatamente	d͡ʒus̪t̪ifikät̪äme̞n̪t̪e	wiki
giustificatezza	d͡ʒus̪t̪ifikät̪e̞t̪t̪͡s̪ä	wiki
giustificativo	d͡ʒus̪t̪ifikät̪iːvo	wiki
giustificato	d͡ʒus̪t̪ifikäːt̪o̞	wiki
giustificatore	d͡ʒus̪t̪ifikät̪o̞ːr̺e	wiki
giustificatori	d͡ʒus̪t̪ifikät̪o̞ːr̺i	wiki
giustificatori	d͡ʒus̪t̪ifikät̪ɔːr̺i	wiki
giustificatorio	d͡ʒus̪t̪ifikät̪ɔːr̺jo	wiki
giustificazionismo	d͡ʒus̪t̪ifikät̪t̪͡s̪jon̺iz̪mo	wiki
giustizia	d͡ʒus̪t̪it̪t̪͡s̪jä	wiki
giustizialismo	d͡ʒus̪t̪it̪t̪͡s̪jäl̺iz̪mo	wiki
giustizialista	d͡ʒus̪t̪it̪t̪͡s̪jäl̺is̪t̪ä	wiki
giustiziare	d͡ʒus̪t̪it̪t̪͡s̪jäːr̺e̞	wiki
giustiziere	d͡ʒus̪t̪it̪t̪͡s̪jɛːr̺e	wiki
giusto	d͡ʒus̪t̪o	wiki
glaciale	ɡl̺ät͡ʃäːl̺e̞	wiki
gladiatorio	ɡl̺äd̪jät̪ɔːr̺jo	wiki
gladio	ɡl̺äːd̪jo	wiki
glassa	ɡl̺äs̪s̪ä	wiki
glena	ɡl̺ɛːn̺ä	wiki
glene	ɡl̺ɛːn̺e	wiki
glenoide	ɡl̺en̺ɔːid̪e	wiki
glenoideo	ɡl̺en̺oi̯d̪ɛːo	wiki
glicine	ɡl̺iːt͡ʃin̺e	wiki
glicocalice	ɡl̺ikokäːl̺it͡ʃe	wiki
glicoplastico	ɡl̺ikopl̺äs̪t̪iko	wiki
glifo	ɡl̺iːfo	wiki
gloria	ɡl̺ɔːr̺jä	wiki
gloriare	ɡl̺or̺jäːr̺e̞	wiki
glottale	ɡl̺ot̪t̪äːl̺e̞	wiki
glottidale	ɡl̺ot̪ːid̪äːl̺e̞	wiki
glottide	ɡl̺ɔt̪t̪id̪e	wiki
gluma	ɡl̺uːmä	wiki
gna	ɲä	wiki
gnidio	ɲiːd̪jo	wiki
gnostico	ɲɔs̪t̪iko	wiki
gobide	ɡɔːbid̪e	wiki
golo	ɡɔːl̺o	wiki
gombito	ɡombit̪o	wiki
gomito	ɡoːmit̪o	wiki
gommalacca	ɡomːäl̺äkːä	wiki
gonfio	ɡoɱfjo	wiki
gonfosi	ɡoɱfɔːz̪i	wiki
googlare	ɡuɡl̺äːr̺e̞	wiki
google	ɡuːɡol	wiki
gorgia	ɡɔr̺d͡ʒä	wiki
gorgone	ɡor̺ɡoːn̺e	wiki
gorgone	ɡɔr̺ɡon̺e	wiki
gorgonzola	ɡor̺ɡon̪d̪͡z̪ɔːl̺ä	wiki
gracchia	ɡr̺äkk̟jä	wiki
gracchio	ɡr̺äkk̟jo	wiki
gradare	ɡr̺äd̪äːr̺e̞	wiki
graffiare	ɡraffjare	wiki
graffito	ɡr̺äfːiːt̪o	wiki
gran	ɡr̺än̺	wiki
granché	ɡräŋ̟k̟e	wiki
grande	ɡr̺än̪d̪e̞	wiki
grandemente	ɡr̺än̪d̪e̞men̪t̪e	wiki
grandordine	ɡr̺än̪d̪or̺d̪in̺e	wiki
granguignolesco	ɡr̺äŋɡiɲɲol̺es̪ko	wiki
graolo	ɡr̺äo̯l̺o	wiki
grascia	ɡr̺äʃʃä	wiki
grasso	ɡr̺äs̪s̪o̞	wiki
grattabugia	ɡr̺ät̪t̪äbuːd͡ʒä	wiki
grattacielo	ɡr̺ät̪ːät͡ʃjeːl̺o	wiki
grattapugia	ɡr̺ät̪t̪äpuːd͡ʒä	wiki
gratuito	ɡr̺ät̪uiːt̪o	wiki
gratuito	ɡr̺ät̪ui̯t̪o	wiki
gratuito	ɡr̺ät̪uːit̪o	wiki
gratuito	ɡr̺ät̪wiːt̪o	wiki
gravitazione	ɡravitatsjone	wiki
gravolo	ɡr̺äːvo̞l̺o	wiki
grazioso	ɡrät̪͡ːs̪joːso	wiki
grazioso	ɡrät̪͡ːs̪joːzo	wiki
grecia	ɡr̺ɛːt͡ʃa	wiki
greco	ɡr̺ɛːko	wiki
gremio	ɡr̺ɛːmjo	wiki
greppa	ɡr̺eppä	wiki
greppo	ɡr̺eppo	wiki
grillino	ɡrilːiːno	wiki
grillo	ɡr̺il̺l̺o	wiki
grissinificio	ɡrisːinifiːt͡ʃo	wiki
grissino	ɡrisːiːno	wiki
grongo	ɡr̺oŋɡo	wiki
grossomodo	ɡr̺os̪s̪omɔːd̪o	wiki
grossomodo	ɡr̺ɔs̪s̪omɔːd̪o	wiki
grossularia	ɡr̺os̪s̪ul̺äːr̺jä	wiki
grotticella	ɡr̺ot̪t̪it͡ʃɛl̺l̺ä	wiki
guadiana	ɡwädjäːnä	wiki
guado	ɡwäːd̪o	wiki
guaio	ɡwäːjo	wiki
gualdrappa	ɡwäl̪d̪r̺äppä	wiki
gualtiero	ɡwäl̪t̪jɛːro	wiki
guantato	ɡwän̪t̪äːt̪o̞	wiki
guanto	ɡwän̪t̪o̞	wiki
guardabarriere	ɡwär̺d̪äbär̺r̺jɛːr̺e	wiki
guardaboschi	ɡwär̺d̪äbɔs̪k̟i	wiki
guardabuoi	ɡwär̺d̪äbwɔi̯	wiki
guardacaccia	ɡwär̺d̪äkatt͡ʃä	wiki
guardalinee	ɡwär̺d̪äl̺iːn̺ee̯	wiki
guardare	ɡwär̺d̪äːr̺e̞	wiki
guardarsene	ɡwär̺d̪är̺s̪e̞n̺e	wiki
guardaspalle	ɡwär̺d̪äs̪päl̺l̺e̞	wiki
guardiacaccia	ɡwär̺d̪jäkätt͡ʃä	wiki
guardialinee	ɡwär̺d̪jäl̺iːn̺ee̯	wiki
guardo	ɡwär̺d̪o̞	wiki
guardolo	ɡwär̺d̪o̞l̺o	wiki
guardrail	ɡär̺d̪r̺ɛi̯l̺	wiki
guargango	ɡwär̺ɡäŋɡo̞	wiki
guastare	ɡwäs̪t̪äːr̺e̞	wiki
guastarsi	ɡwäs̪t̪är̺s̪i	wiki
guatare	ɡwät̪äːr̺e̞	wiki
guazzetto	ɡwät̪t̪͡s̪e̞t̪t̪o	wiki
guerra	ɡwɛr̺ːä	wiki
guerreggiare	ɡwer̺r̺edd͡ʒäːr̺e̞	wiki
guerriglia	ɡwer̺r̺iʎʎä	wiki
guerrigliero	ɡwer̺r̺iʎʎɛːr̺o	wiki
gufo	ɡuːfo	wiki
guidapopolo	ɡwid̪äpɔːpol̺o	wiki
guidare	ɡwid̪äːr̺e̞	wiki
guisarma	ɡwiz̪är̺mä	wiki
guitto	ɡwit̪t̪o	wiki
guscio	ɡuʃʃo	wiki
gusto	ɡust̪o	wiki
gutturale	ɡut̪t̪ur̺äːl̺e̞	wiki
hanno	än̺ːo̞	wiki
henna	ɛn̺n̺ä	wiki
heth	ɛt̪	wiki
hinterland	in̪t̪er̺l̺an̪d̪	wiki
historia	is̪t̪ɔːr̺jä	wiki
hotel	ot̪ɛl̺	wiki
iambe	jämbe̞	wiki
iarda	jard̪a	wiki
ibis	iːbis̪	wiki
icastico	ikäs̪t̪iko	wiki
ics	iks̪	wiki
identikit	identikit	wiki
idiosincrasia	id̪josiŋkr̺äziːä	wiki
idolatra	id̪ol̺äːt̪r̺ä	wiki
idrogeno	id̪r̺ɔːd͡ʒen̺o	wiki
idromante	id̪r̺omän̪t̪e̞	wiki
idromanzia	id̪r̺omänt̪͡s̪iä̯	wiki
ieri	jɛːr̺i	wiki
iernotte	jer̺n̺ɔt̪ːe	wiki
iglù	iɡl̺u	wiki
ignazio	iɲɲäːt̪͡s̪jo	wiki
igne	iɲɲe	wiki
igneo	iɲːeo̯	wiki
ignoranza	iɲɲor̺an̪t̪͡s̪a	wiki
ignudare	iɲɲud̪äːr̺e̞	wiki
igrocasia	iɡr̺okäz̪iä̯	wiki
igrocasia	iɡr̺okäz̪iːä	wiki
igrocastico	iɡr̺okäs̪t̪iko	wiki
ilarotragedia	il̺är̺o̞t̪r̺äd͡ʒɛːd̪jä	wiki
ilarotragedie	il̺är̺o̞t̪r̺äd͡ʒɛːd̪je	wiki
ilda	il̪d̪ä	wiki
illune	il̺l̺uːn̺e	wiki
ilvaite	il̺väiːt̪e	wiki
imbarazzo	imbär̺ät̪t̪͡s̪o̞	wiki
imbroncare	imbr̺oŋkäːr̺e̞	wiki
imbusto	imbus̪t̪o	wiki
immemore	immɛːmor̺e	wiki
immillare	immil̺l̺är̺e̞	wiki
immillarsi	immil̺l̺är̺s̪i	wiki
immolate	immolaːt̪e	wiki
immunochimica	immun̺ok̟iːmika	wiki
immunochimico	immun̺ok̟iːmiko	wiki
immunocompetente	immun̺okompetɛn̪t̪e	wiki
immunocompetenza	immun̺okompetɛn̪t̪͡s̪a	wiki
immunocomplesso	immun̺okompl̺ɛs̪s̪o	wiki
immunodeficiente	immun̺od̪efit͡ʃɛn̪t̪e	wiki
immunodeficienza	imːun̺od̪efit͡ʃɛn̪t̪͡s̪a	wiki
imo	iːmo	wiki
impagliare	impäʎʎäːr̺e̞	wiki
impazzire	impät̪͡ːs̪iːre	wiki
impelagarsi	impel̺äɡär̺s̪i	wiki
imperciocché	imper̺t͡ʃokke	wiki
imperciò	imper̺t͡ʃɔ	wiki
imperitamente	imper̺it̪äme̞n̪t̪e	wiki
imperito	imper̺iːt̪o	wiki
imperituro	imper̺it̪uːr̺o	wiki
imperizia	imper̺it̪t̪͡s̪jä	wiki
impiagare	impjäɡäːr̺e̞	wiki
impiccagione	impikkäd͡ʒo̞ːn̺e	wiki
impiccare	impikkäːr̺e̞	wiki
impiccato	impikkäːt̪o̞	wiki
impiccatore	impikkät̪o̞ːr̺e	wiki
impiccatura	impikkät̪uːr̺ä	wiki
impiegatizio	impjeɡät̪it̪͡ːs̪jo	wiki
impillaccherare	impil̺l̺äkke̞r̺äːr̺e̞	wiki
improntitudine	impr̺on̪t̪it̪uːd̪in̺e	wiki
impudente	impud̪ɛn̪t̪e	wiki
in	in̺	wiki
inabilitanda	in̺äbil̺it̪än̪d̪ä	wiki
inabilitando	in̺äbil̺it̪än̪d̪o̞	wiki
inalbare	in̺äl̺bäːr̺e̞	wiki
inalbarsi	in̺äl̺bär̺s̪i	wiki
inane	in̺äːn̺e̞	wiki
inaridire	in̺är̺id̪iːr̺e	wiki
inaridirsi	in̺är̺id̪ir̺s̪i	wiki
inattendibilità	in̺ät̪t̪e̞n̪d̪ibil̺it̪ä	wiki
incantagione	iŋkän̪t̪äd͡ʒo̞ːn̺e	wiki
incantazione	iŋkän̪t̪ät̪t̪͡s̪jo̞ːn̺e	wiki
incanutire	iŋkän̺ut̪iːr̺e	wiki
incaparbire	iŋkäpär̺biːr̺e	wiki
incaparbirsi	iŋkäpär̺bir̺s̪i	wiki
incastonare	iŋkäs̪t̪o̞n̺äːr̺e̞	wiki
incendere	in̺ʲt͡ʃɛn̪d̪er̺e	wiki
inceso	in̺ʲt͡ʃeːz̪o	wiki
inchiudere	iŋk̟juːd̪er̺e	wiki
inclemente	iŋkl̺emɛn̪t̪e	wiki
inclito	iŋklit̪o	wiki
inconseguente	iŋkon̪s̪eɡwɛn̪t̪e	wiki
inconsutile	iŋkon̪s̪uːt̪il̺e	wiki
incontro	iŋkon̪t̪r̺o	wiki
incudine	iŋkuːd̪in̺e	wiki
indagine	in̪d̪äːdʒin̺e	wiki
indeclinabile	in̪d̪ekl̺in̺äːbil̺e	wiki
indefinito	in̪d̪efin̺iːt̪o	wiki
indelebile	in̪d̪el̺ɛːbil̺e	wiki
indigenza	in̪d̪id͡ʒɛn̪t̪͡s̪a	wiki
indole	in̪d̪ol̺e	wiki
indolenza	in̪d̪ol̺ɛn̪t̪͡s̪ä	wiki
indomo	in̪d̪oːmo	wiki
indotto	in̪d̪ot̪t̪o	wiki
indotto	in̪d̪ɔt̪t̪o	wiki
indugia	in̪d̪uːd͡ʒä	wiki
indugiare	in̪d̪ud͡ʒäːr̺e̞	wiki
indulgere	in̪d̪ul̺ʲd͡ʒer̺e	wiki
indurre	indurre	wiki
inerpicarsi	in̺er̺pikär̺s̪i	wiki
inettitudine	in̺et̪ːit̪uːd̪in̺e	wiki
infacondo	iɱfäko̞n̪d̪o	wiki
infando	iɱfän̪d̪o̞	wiki
infedele	iɱfed̪eːl̺e	wiki
infedelmente	iɱfed̪el̺men̪t̪e	wiki
infedeltà	iɱfed̪el̺t̪ä	wiki
inferiore	iɱfer̺joːr̺e	wiki
inferiorità	iɱfer̺jor̺it̪ä	wiki
infermiere	iɱfer̺mjɛːr̺e	wiki
infero	iɱfer̺o	wiki
infidamente	iɱfid̪äme̞n̪t̪e	wiki
infido	iɱfiːd̪o	wiki
infimo	iɱfimo	wiki
infinito	infiniːt̪o	wiki
influenza	iɱfluɛnt̪s̪͡a	wiki
infrancesare	iɱfr̺än̺ʲt͡ʃe̞z̪äːr̺e̞	wiki
infranciosare	iɱfr̺än̺ʲt͡ʃo̞z̪äːr̺e̞	wiki
infuriare	iɱfur̺jäːr̺e̞	wiki
infuriarsi	iɱfur̺jär̺s̪i	wiki
ingaggiare	iŋɡädd͡ʒäːr̺e̞	wiki
ingaggio	iŋɡäd͡ːʒo̞	wiki
inghilterra	iŋɡiltɛrra	wiki
ingiudicato	in̺ʲd͡ʒud̪ikäːt̪o̞	wiki
ingiuria	in̺ʲd͡ʒuːr̺jä	wiki
ingiuriante	in̺ʲd͡ʒur̺jän̪t̪e̞	wiki
ingiuriare	in̺ʲd͡ʒur̺jäːr̺e̞	wiki
ingiuriato	in̺ʲd͡ʒur̺jäːt̪o̞	wiki
ingiuriatore	in̺ʲd͡ʒur̺jät̪o̞ːr̺e	wiki
ingiuriatrice	in̺ʲd͡ʒur̺jät̪r̺iːt͡ʃe	wiki
ingiuriosamente	in̺ʲd͡ʒur̺joz̪äme̞n̪t̪e	wiki
ingiurioso	in̺ʲd͡ʒur̺joːz̪o	wiki
ingiustamente	in̺ʲd͡ʒus̪t̪äme̞n̪t̪e	wiki
ingiustificabile	in̺ʲd͡ʒus̪t̪ifikäːbil̺e	wiki
ingiustificabilità	in̺ʲd͡ʒus̪t̪ifikäbil̺it̪ä	wiki
ingiustificabilmente	in̺ʲd͡ʒus̪t̪ifikäbil̺men̪t̪e	wiki
ingiustificatamente	in̺ʲd͡ʒus̪t̪ifikät̪äme̞n̪t̪e	wiki
ingiustificato	in̺ʲd͡ʒus̪t̪ifikäːt̪o̞	wiki
ingiustizia	in̺ʲd͡ʒus̪t̪it̪t̪͡s̪jä	wiki
ingiusto	in̺ʲd͡ʒus̪t̪o	wiki
ingratitudine	iŋɡr̺ät̪it̪uːd̪in̺e	wiki
ingurgitare	iŋɡur̺d͡ʒit̪äːr̺e̞	wiki
inguscezia	iŋɡuʃʃɛt̪t̪͡s̪jä	wiki
inguscia	iŋɡuʃʃä	wiki
inguscio	iŋɡuʃʃo	wiki
inia	iːn̺jä	wiki
iniziando	in̺it̪t̪͡s̪jän̪d̪o̞	wiki
iniziatico	in̺it̪t̪͡s̪jäːt̪iko	wiki
inleiarsi	in̺l̺ejär̺s̪i	wiki
inluiarsi	in̺l̺ujär̺s̪i	wiki
inmiarsi	in̺miär̺s̪i	wiki
innevare	in̺n̺eväːr̺e̞	wiki
innevarsi	in̺n̺evär̺s̪i	wiki
innevato	in̺n̺eväːt̪o̞	wiki
innocentare	in̺n̺ot͡ʃen̪t̪äːr̺e̞	wiki
innocente	in̺n̺ot͡ʃɛn̪t̪e	wiki
innocentemente	in̺n̺ot͡ʃen̪t̪emen̪t̪e	wiki
innocentismo	in̺n̺ot͡ʃen̪t̪iz̪mo	wiki
innocentista	in̺n̺ot͡ʃen̪t̪is̪t̪ä	wiki
innocentizzazione	in̺n̺ot͡ʃen̪t̪id̪͡ːz̪ät̪t̪͡s̪joːn̺e	wiki
innocenza	in̺n̺ot͡ʃɛn̪t̪͡s̪ä	wiki
innocuamente	in̺n̺okwäme̞n̪t̪e	wiki
innocuità	in̺n̺okwit̪ä	wiki
innocuizzare	in̺n̺okwid̪d̪͡z̪äːr̺e̞	wiki
innocuo	in̺n̺ɔːkwo	wiki
innodico	in̺n̺ɔːd̪iko	wiki
innovare	in̺ːoväːr̺e̞	wiki
ino	iːn̺o	wiki
inobliabile	obl̺iäːbil̺e	wiki
inobliabile	obl̺jäːbil̺e	wiki
inodiare	in̺od̪jäːr̺e̞	wiki
inodore	in̺od̪oːr̺e	wiki
inodoro	in̺od̪oːr̺o	wiki
inoltre	in̺ol̪t̪r̺e	wiki
inqueto	iŋkwɛːt̪o	wiki
inquietamente	iŋkwjet̪äme̞n̪t̪e	wiki
inquietante	iŋkwjet̪än̪t̪e̞	wiki
inquietare	iŋkwjet̪är̺e̞	wiki
inquietarsi	iŋkwjet̪är̺s̪i	wiki
inquietezza	iŋkwjet̪et̪t̪͡s̪ä	wiki
inquieto	iŋkwjɛːt̪o	wiki
inquietudine	iŋkwjet̪uːd̪in̺e	wiki
inquilina	iŋkwil̺iːn̺ä	wiki
inquilinato	iŋkwil̺in̺äːt̪o̞	wiki
inquilinismo	iŋkwil̺in̺iz̪mo	wiki
inquilino	iŋkwil̺iːn̺o	wiki
inquinare	iŋkwin̺äːr̺e̞	wiki
insaponamento	in̪s̪äpo̞n̺äme̞n̪t̪o	wiki
insaponare	in̪s̪äpo̞n̺äːr̺e̞	wiki
insaponatura	in̪s̪äpo̞n̺ät̪uːr̺ä	wiki
inseguire	in̪s̪eɡwiːr̺e	wiki
insicuro	in̪s̪ikuːr̺o	wiki
insieme	insjɛːme	wiki
insobrio	in̪s̪ɔːbr̺jo	wiki
insonne	in̪s̪ɔn̺n̺e	wiki
insonnia	in̪s̪ɔn̺n̺jä	wiki
insonnolire	in̪s̪on̺n̺ol̺iːr̺e	wiki
insonnolito	in̪s̪on̺n̺ol̺iːt̪o	wiki
installare	in̪sta̞l̺ːaːɾe	wiki
instrumento	in̪s̪t̪r̺umen̪t̪o	wiki
insussurrare	in̪s̪us̪s̪ur̺r̺äːr̺e̞	wiki
intarsiare	in̪t̪är̺s̪jäːr̺e̞	wiki
intarsio	in̪t̪är̺s̪jo	wiki
intellighenzia	in̪t̪el̺ːiɡ̟ɛn̪t̪͡s̪jä	wiki
intercorrere	in̪t̪er̺kor̺r̺er̺e	wiki
interduna	in̪t̪er̺d̪uːn̺ä	wiki
interdunale	in̪t̪er̺d̪un̺äːl̺e̞	wiki
interfrangia	in̪t̪er̺fr̺än̺ʲd͡ʒä	wiki
interiettivo	in̪t̪er̺jet̪t̪iːvo	wiki
interiezione	in̪t̪er̺jet̪͡s̪joːn̺e	wiki
interlobo	in̪t̪er̺l̺ɔːbo	wiki
internet	in̪t̪er̺n̺et̪	wiki
internet	in̪t̪er̺n̺ɛt̪	wiki
interscambiare	in̪t̪er̺s̪kämbjäːr̺e̞	wiki
intervocalico	in̪t̪er̺vokäːl̺iko	wiki
intestino	intestino	wiki
intombare	in̪t̪ombäːr̺e̞	wiki
intorbare	in̪t̪or̺bäːr̺e̞	wiki
intossicare	in̪t̪os̪s̪ikäːr̺e̞	wiki
intralasciare	in̪t̪r̺äl̺äʃʃäːr̺e̞	wiki
intrare	in̪t̪r̺är̺e̞	wiki
intrata	in̪t̪r̺äːt̪ä	wiki
intrudere	in̪t̪r̺uːd̪er̺e	wiki
intruso	in̪t̪r̺uːz̪o	wiki
intuarsi	in̪t̪uär̺s̪i	wiki
inulto	in̺ul̪t̪o	wiki
inusuale	in̺uz̪uäːl̺e̞	wiki
inusuale	in̺uz̪wäːl̺e̞	wiki
invalicabile	iɱväl̺ikäːbil̺e	wiki
invariante	invarjant̪e	wiki
invelenire	iɱvel̺en̺iːr̺e	wiki
invelenirsi	iɱvel̺en̺ir̺s̪i	wiki
invendicabile	iɱven̪d̪ikäːbil̺e	wiki
inverno	iɱvɛr̺n̺o	wiki
inviolabile	iɱvjol̺äːbil̺e	wiki
invocare	iɱvokäːr̺e̞	wiki
invocazione	iɱvokät̪͡s̪joːn̺e	wiki
inzaccherare	in̪d̪͡z̪äkke̞r̺äːr̺e̞	wiki
inzaccherarsi	in̪d̪͡z̪äkke̞r̺är̺s̪i	wiki
io	io̯	wiki
io	iːo	wiki
iod	jɔd̪	wiki
iodare	jod̪äːr̺e̞	wiki
iota	jɔːt̪ä	wiki
ipetro	ipɛːt̪r̺o	wiki
ipnosi	ipn̺ɔːz̪i	wiki
ipnoticamente	ipn̺ot̪ikäme̞n̪t̪e	wiki
ipnotico	ipn̺ɔːt̪iko	wiki
ipnotizzare	ipn̺ot̪id̪d̪͡z̪äːr̺e̞	wiki
ipnotizzatore	ipn̺ot̪id̪d̪͡z̪ät̪o̞ːr̺e̞	wiki
ipofrigio	ipofr̺iːd͡ʒo	wiki
ipogeo	ipod͡ʒɛo̯	wiki
iponimo	ipɔːn̺imo	wiki
ipoplasico	ipopl̺äːz̪iko	wiki
ipoplastico	ipopl̺äs̪t̪iko	wiki
ipsilon	ips̪il̺on̺	wiki
irenico	ir̺ɛːn̺iko	wiki
iridato	ir̺id̪äːt̪o̞	wiki
iridescenza	ir̺id̪eʃʃɛn̪t̪͡s̪ä	wiki
iridico	ir̺iːd̪iko	wiki
irlanda	ir̺l̺än̪d̪ä	wiki
irlandese	ir̺l̺än̪d̪e̞ːz̪e	wiki
irraggiamento	ir̺ːäd͡ːʒäme̞n̪t̪o	wiki
irraggiare	ir̺ːäd͡ːʒäːr̺e̞	wiki
irreprensibile	ir̺r̺epr̺en̪s̪iːbil̺e	wiki
irrequietezza	ir̺r̺ekwjet̪et̪t̪͡s̪ä	wiki
irrequieto	ir̺r̺ekwjɛːt̪o	wiki
irrequietudine	ir̺r̺ekwjet̪uːd̪in̺e	wiki
irrintracciabilità	ir̺ːin̪t̪r̺ät͡ːʃäbil̺it̪ä	wiki
irto	ir̺t̪o	wiki
isbaglio	iz̪bäʎʎo̞	wiki
ischia	is̪kjä	wiki
ischiadico	is̪kjäːd̪iko	wiki
ischiatico	is̪kjäːt̪iko	wiki
ischio	is̪kjo	wiki
iscuria	is̪kuːr̺jä	wiki
iside	iːz̪id̪e	wiki
islanda	iz̪l̺än̪d̪ä	wiki
islandese	iz̪l̺än̪d̪e̞ːz̪e	wiki
islandico	iz̪l̺än̪d̪iko	wiki
isochimena	iz̪ok̟imɛːn̺ä	wiki
isola	iːzola	wiki
isolare	izolaːre	wiki
israele	izraɛːle	wiki
istoradiografia	is̪t̪or̺äd̪joɡr̺äfiːä	wiki
istoria	is̪t̪ɔːr̺jä	wiki
istriona	is̪t̪r̺joːn̺ä	wiki
istrione	is̪t̪r̺joːn̺e	wiki
istrumento	is̪t̪r̺umen̪t̪o	wiki
itala	iːt̪äl̺ä	wiki
italia	it̪äːl̺jä	wiki
italiana	it̪al̺jaːn̺a	wiki
italianese	it̪äl̺jän̺e̞ːz̪e	wiki
italianizzare	it̪al̺jan̺idd̪͡z̪aːr̺e	wiki
italianizzato	it̪al̺jan̺idd̪͡z̪aːt̪o	wiki
italianizzazione	it̪äl̺jän̺id̪d̪͡z̪ät̪͡s̪joːn̺e	wiki
italiano	it̪äl̺jäːn̺o̞	wiki
italiesco	it̪äl̺je̞s̪ko	wiki
italo	iːt̪äl̺o̞	wiki
iubere	juːber̺e	wiki
iudicare	jud̪ikäːr̺e̞	wiki
iudicato	jud̪ikäːt̪o̞	wiki
iudice	juːd̪it͡ʃe	wiki
iudici	jud̪iːt͡ʃi	wiki
iudici	juːd̪it͡ʃi	wiki
iudicio	jud̪iːt͡ʃo	wiki
iugero	juːd͡ʒer̺o	wiki
iure	juːr̺e	wiki
iussivo	jus̪s̪iːvo	wiki
ivi	iːvi	wiki
j	dʒ	wiki
j	j	wiki
j	ʒ	wiki
jazz	d͡ʒäz̪	wiki
jazz	d͡ʒɛz̪	wiki
jazzistico	d͡ʒäd̪d̪͡z̪is̪t̪iko	wiki
joyciano	d͡ʒoi̯sːjäːno	wiki
jugoslavia	juɡoz̪l̺äːvjä	wiki
jugoslavo	juɡoz̪l̺äːvo̞	wiki
k	k	wiki
k	kʰ	wiki
kaf	käf	wiki
kamikaze	kämikäːd̪͡z̪e̞	wiki
kamikaze	kämikäːz̪e̞	wiki
kappa	käppä	wiki
karma	kär̺mä	wiki
katiuscia	kät̪juʃʃä	wiki
kebab	kebäb	wiki
kebabbaro	k̟ebäbbäːr̺o̞	wiki
khan	kän̺	wiki
khanati	kän̺äːt̪i	wiki
khanato	kän̺äːt̪o̞	wiki
killer	k̟il̺l̺er̺	wiki
killeraggio	k̟il̺l̺er̺ädd͡ʒo̞	wiki
killerare	k̟il̺l̺er̺äːr̺e̞	wiki
kyrie	k̟iːrje	wiki
kyrieleison	k̟irjelɛi̯son	wiki
l'aia	l‿äːjä	wiki
labbra	l̺äbːr̺ä	wiki
labbro	läbːɾo	wiki
labdacismo	l̺abd̪at͡ʃiz̪mo	wiki
labiale	l̺äbjäːl̺e̞	wiki
labializzare	l̺äbjäl̺id̪d̪͡z̪äːr̺e̞	wiki
labializzarsi	l̺äbjäl̺id̪͡ːz̪är̺s̪i	wiki
labializzazione	l̺äbjäl̺id̪d̪͡z̪ät̪͡s̪joːn̺e	wiki
labiodentale	l̺äbjod̪en̪t̪äːl̺e̞	wiki
labro	l̺äːbr̺o̞	wiki
lacedemonio	l̺ät͡ʃe̞d̪emɔːn̺jo	wiki
lactagogo	l̺akt̪aɡɔːɡo	wiki
ladrocinio	l̺äd̪r̺o̞t͡ʃiːn̺jo	wiki
ladrona	l̺äd̪r̺oːn̺ä	wiki
ladroncella	l̺äd̪r̺o̞n̺ʲt͡ʃɛl̺l̺ä	wiki
ladroncello	l̺äd̪r̺o̞n̺ʲt͡ʃɛl̺l̺o	wiki
ladroneccio	l̺äd̪r̺o̞n̺ett͡ʃo	wiki
ladroneggio	l̺äd̪r̺o̞n̺edd͡ʒo	wiki
lama	l̺äːmä	wiki
lambdacismo	l̺ambd̪at͡ʃiz̪mo	wiki
lambrusco	lambrusko	wiki
lamed	l̺ämed̪	wiki
lampeggiamento	l̺ämpe̞dd͡ʒäme̞n̪t̪o	wiki
lanciabas	län̺ʲt͡ʃäbäs̪	wiki
lanciabombe	l̺än̺ʲt͡ʃäbo̞mbe	wiki
lanciare	lantʃare	wiki
langarolo	läŋɡärɔːlo	wiki
langhe	läŋɡ̟e	wiki
laosiano	l̺äo̯sjäːn̺o	wiki
laosiano	l̺äo̯zjäːn̺o	wiki
laotiano	l̺äo̯t̪jäːn̺o	wiki
lapide	l̺äːpid̪e	wiki
lapidescente	l̺äpid̪eʃʃɛn̪t̪e	wiki
lardo	l̺är̺d̪o̞	wiki
largo	larɡo	wiki
lassa	l̺äs̪s̪ä	wiki
lasso	l̺äs̪s̪o̞	wiki
latamente	l̺ät̪äme̞n̪t̪e	wiki
laterizio	l̺ät̪er̺it̪͡ːs̪jo	wiki
latirismo	l̺ät̪ir̺iz̪mo	wiki
latiro	l̺äːt̪ir̺o	wiki
lato	l̺äːt̪o̞	wiki
latroneccio	l̺ät̪r̺o̞n̺ett͡ʃo	wiki
lattagogo	l̺ät̪ːäɡɔːɡo	wiki
lattaio	l̺ät̪t̪äːjo	wiki
lattaiola	l̺ät̪t̪äjɔːl̺ä	wiki
lattaiolo	l̺ät̪t̪äjɔːl̺o	wiki
lattario	l̺ät̪t̪äːr̺jo	wiki
latte	l̺ät̪t̪e̞	wiki
latticello	l̺ät̪t̪it͡ʃɛl̺l̺o	wiki
lattone	l̺ät̪t̪o̞ːn̺e	wiki
lattonzo	l̺ät̪t̪o̞n̪t̪͡s̪o	wiki
lattonzolo	l̺ät̪t̪o̞n̪t̪͡s̪ol̺o	wiki
lattuccio	l̺ät̪t̪utt͡ʃo	wiki
lattugaccio	l̺ät̪t̪uɡätt͡ʃo̞	wiki
lattughella	l̺ät̪t̪uɡɛl̺l̺ä	wiki
lattughetta	l̺ät̪t̪uɡet̪t̪ä	wiki
lattughina	l̺ät̪t̪uɡ̟iːn̺ä	wiki
lauda	läu̯d̪ä	wiki
lauroceraso	l̺äu̯r̺ot͡ʃer̺äːz̪o̞	wiki
lavabiancheria	l̺äväbjaŋk̟er̺iːä	wiki
lavastoviglie	l̺äväs̪t̪o̞viʎːe	wiki
lavavetri	l̺äväveːt̪r̺i	wiki
lavorista	l̺ävo̞r̺is̪t̪ä	wiki
lazio	l̺ät̪t̪͡s̪jo	wiki
lazo	l̺ät̪t̪͡s̪o̞	wiki
lazzaro	l̺äd̪d̪͡z̪är̺o̞	wiki
leader	l̺iːd̪er̺	wiki
leccornia	lekːorniːä	wiki
lecito	leːt͡ʃit̪o	wiki
ledere	l̺ɛːd̪er̺e	wiki
legalizzare	l̺eɡäl̺id̪d̪͡z̪äːr̺e̞	wiki
legalizzazione	l̺eɡäl̺id̪͡ːz̪ät̪͡s̪joːn̺e	wiki
legare	leɡare	wiki
leggiadria	l̺edd͡ʒäd̪r̺iːä	wiki
leggiadro	l̺edd͡ʒäːd̪r̺o̞	wiki
lei	lɛːi	wiki
lene	l̺eːn̺e	wiki
lene	l̺ɛːn̺e	wiki
leninismo	l̺en̺in̺iz̪mo	wiki
leninista	l̺en̺in̺is̪t̪a	wiki
leonardesco	leonärd̪esko	wiki
leonardesco	le̯onärd̪esko	wiki
lepidamente	l̺epid̪äme̞n̪t̪e	wiki
lepidezza	l̺epid̪et̪͡ːs̪ä	wiki
lepido	l̺ɛːpid̪o	wiki
lepidoblastico	l̺epid̪obl̺äs̪t̪iko	wiki
lercio	l̺er̺t͡ʃo	wiki
lercio	l̺ɛr̺t͡ʃo	wiki
lesione	l̺ez̪joːn̺e	wiki
lesivo	l̺ez̪iːvo	wiki
leso	l̺eːz̪o	wiki
lesto	lɛːst̪o	wiki
letargia	l̺et̪är̺d͡ʒiːä	wiki
letterario	l̺et̪t̪er̺äːr̺jo	wiki
leucoblastico	l̺eu̯kobl̺äs̪t̪iko	wiki
levante	l̺evän̪t̪e̞	wiki
levirato	l̺evir̺äːt̪o̞	wiki
levogiro	l̺evod͡ʒiːr̺o	wiki
li	l̺i	wiki
libamento	l̺ibäme̞n̪t̪o	wiki
libercolo	l̺ibɛr̺kol̺o	wiki
libito	l̺iːbit̪o	wiki
libreria	libreriːa	wiki
licantropo	l̺ikän̪t̪r̺o̞po	wiki
lichenizzazione	l̺iken̺id̪d̪͡z̪ät̪t̪͡s̪joːn̺e	wiki
licito	l̺iːt͡ʃit̪o	wiki
lieve	l̺jɛːve	wiki
ligneo	l̺iɲːeo	wiki
ligneo	l̺iɲːe̯o	wiki
ligustico	liɡus̪t̪iko	wiki
lilla	lilːä	wiki
limo	l̺iːmo	wiki
limoncello	limon̠ʲt͡ʃɛlːo	wiki
limoncino	limon̠ʲt͡ʃiːno	wiki
linfagogo	l̺iɱfäɡɔːɡo	wiki
linfoblastico	l̺iɱfobl̺äs̪t̪iko	wiki
linfoblasto	l̺iɱfobl̺äs̪t̪o̞	wiki
lingua	liŋɡwa	wiki
linguattola	l̺iŋɡwät̪t̪o̞l̺ä	wiki
linguina	liŋɡwiːnä	wiki
linguine	liŋɡwiːne	wiki
linguistica	liŋɡwiːst̪ika	wiki
linguolabiale	l̺iŋɡwol̺äbjäːl̺e̞	wiki
lino	l̺iːn̺o	wiki
linoleum	l̺in̺ɔːl̺eu̯m	wiki
lippo	l̺ippo	wiki
liquame	l̺ikwäːme̞	wiki
lira	l̺iːr̺ä	wiki
lirico	l̺iːr̺iko	wiki
lirista	l̺ir̺is̪t̪ä	wiki
liscio	liʃʃo	wiki
liticine	l̺it̪iːt͡ʃin̺e	wiki
litio	l̺iːt̪jo	wiki
litochelifopedio	l̺it̪okel̺ifopɛːd̪jo	wiki
litopedio	l̺it̪opɛːd̪jo	wiki
livermorio	l̺iver̺mɔːr̺jo	wiki
livia	l̺iːvjä	wiki
livido	l̺iːvid̪o	wiki
livornese	livorneːse	wiki
livornese	livorneːze	wiki
loco	l̺ɔːko	wiki
loculo	l̺ɔːkul̺o	wiki
locuzione	l̺okut̪͡s̪joːn̺e	wiki
lodovico	lod̪oviːko	wiki
lombo	l̺ombo	wiki
lombosacrale	l̺ombos̪äkr̺äːl̺e̞	wiki
lombricaio	l̺ombr̺ikäːjo	wiki
londinese	lon̪d̪ineːse	wiki
londinese	lon̪d̪ineːze	wiki
longanime	l̺oŋɡäːn̺ime	wiki
lontano	lontano	wiki
lontra	l̺on̪t̪r̺ä	wiki
lorenzo	l̺or̺ɛn̪t̪͡s̪o	wiki
loro	l̺oːr̺o	wiki
losanga	l̺oz̪äŋɡä	wiki
losco	l̺os̪ko	wiki
lovato	loväːt̪o	wiki
lubrico	l̺ubr̺iːko	wiki
lubrico	l̺uːbr̺iko	wiki
luce	l̺uːt͡ʃe	wiki
lucia	lutʃia	wiki
luciferasi	l̺ut͡ʃifer̺äːz̪i	wiki
luciferiano	l̺ut͡ʃifer̺jäːn̺o̞	wiki
luciferina	l̺ut͡ʃifer̺iːn̺ä	wiki
luciferino	l̺ut͡ʃifer̺iːn̺o	wiki
lucifero	l̺ut͡ʃiːfer̺o	wiki
lucio	luːtʃo	wiki
luco	l̺uːko	wiki
luculento	l̺ukul̺ɛn̪t̪o	wiki
lucumonia	l̺ukumɔːn̺jä	wiki
ludere	l̺uːd̪er̺e	wiki
ludovica	lud̪oviːka	wiki
ludovico	l̺ud̪oviːko	wiki
lue	l̺uːe	wiki
luglio	l̺uʎːo	wiki
lui	lui	wiki
luisa	luiːzä	wiki
lumachella	l̺umäkɛl̺l̺ä	wiki
lume	l̺uːme	wiki
luminare	l̺umin̺äːr̺e̞	wiki
luminio	l̺umin̺io̯	wiki
luminismo	l̺umin̺iz̪mo	wiki
luminista	l̺umin̺is̪t̪ä	wiki
luministica	l̺umin̺is̪t̪ikä	wiki
luministico	l̺umin̺is̪t̪iko	wiki
luna	l̺uːn̺ä	wiki
lunedì	l̺un̺ed̪i	wiki
lunge	l̺un̺ʲd͡ʒe	wiki
lungi	l̺un̺ʲd͡ʒi	wiki
lungo	lunɡo	wiki
lungosenna	l̺uŋɡos̪ɛn̺ːä	wiki
lungotevere	l̺uŋɡot̪eːver̺e	wiki
luogo	l̺wɔːɡo	wiki
lupara	l̺upäːr̺ä	wiki
luparia	l̺upäːr̺jä	wiki
lupo	l̺uːpo	wiki
lusco	l̺us̪ko	wiki
lusignolo	l̺uz̪iɲɲɔːl̺o	wiki
luto	l̺uːt̪o	wiki
là	l̺ä	wiki
macelleria	mät͡ʃe̞l̺l̺er̺iːä	wiki
macellesco	mät͡ʃe̞l̺l̺es̪ko	wiki
macello	mät͡ʃɛl̺l̺o	wiki
maculopapula	mäkul̺opäːpul̺ä	wiki
madido	mäːd̪id̪o	wiki
madore	mäd̪o̞ːr̺e	wiki
madre	mäːd̪r̺e̞	wiki
madrigale	mäd̪r̺iɡäːl̺e̞	wiki
madrigaleggiare	mäd̪r̺iɡäl̺e̞dd͡ʒäːr̺e	wiki
maestro	mäes̪t̪ro	wiki
maestro	mäɛs̪t̪ro	wiki
maggio	mäd͡ːʒo̞	wiki
maggiociondolo	mädd͡ʒo̞t͡ʃon̪d̪ol̺o	wiki
maggiordomo	mädd͡ʒo̞r̺d̪ɔːmo	wiki
maggiore	mädd͡ʒo̞ːr̺e	wiki
magia	mad͡ʒiːä	wiki
magiaro	mäd͡ʒäːr̺o̞	wiki
magmatico	mäɡmäːt̪iko	wiki
magnare	mäɲːäːre	wiki
magnesio	mäɲːɛːzjo	wiki
magone	mäɡoːne	wiki
magreb	mäɡr̺ɛb	wiki
magrebino	mäɡr̺e̞biːn̺o	wiki
magrebizzazione	mäɡr̺e̞bid̪d̪͡z̪ät̪t̪͡s̪joːn̺e	wiki
maiale	majale	wiki
maiore	mäjo̞ːr̺e	wiki
malaccolto	mäl̺äkkɔl̪t̪o	wiki
malalingua	mäl̺äl̺iŋɡwä	wiki
maldestramente	mäl̺d̪es̪t̪r̺äme̞n̪t̪e	wiki
maldicente	mäl̺d̪it͡ʃɛn̪t̪e	wiki
male	maːle	wiki
maledica	mäl̺e̞d̪iːkä	wiki
maledica	mäl̺ɛːd̪ikä	wiki
maledici	mäl̺ed̪iːt͡ʃi	wiki
maledici	mäl̺ɛːd̪it͡ʃi	wiki
maledico	mäl̺ed̪iːko	wiki
maledico	mäl̺ɛːd̪iko	wiki
malfatto	mäl̺fät̪t̪o̞	wiki
malfusso	mäl̺fus̪s̪o	wiki
malo	maːl̺o	wiki
malvagia	mälväd͡ʒiːä	wiki
malvagia	mälväːd͡ʒä	wiki
malvasia	mälväziːä	wiki
manca	mäŋkä	wiki
mancini	män̺ʲt͡ʃiːn̺i	wiki
manciù	män̺ʲt͡ʃu	wiki
manfrina	mäɱfriːnä	wiki
manga	mäŋɡä	wiki
mangiaapi	män̺ʲd͡ʒääːpi	wiki
mangiapatate	män̠ʲd͡ʒäpät̪äːt̪e	wiki
mangiarane	män̠ʲd͡ʒäräːne	wiki
mangiare	män̺ʲd͡ʒäːr̺e̞	wiki
manicomiale	män̺ikomjäːl̺e	wiki
manicomio	män̺ikɔːmjo	wiki
manicotti	manikɔt̪t̪i	wiki
mannaggia	män̺ːäd͡ːʒä	wiki
mannaro	män̺n̺äːr̺o̞	wiki
mano	maːno	wiki
manoscritto	män̺o̞s̪kr̺it̪t̪o	wiki
manoscrivere	män̺o̞s̪kr̺iːver̺e	wiki
manso	män̪s̪o̞	wiki
manufatto	män̺ufät̪t̪o̞	wiki
manutenzione	män̺ut̪en̪t̪͡s̪joːn̺e	wiki
manzoni	män̪d̪͡z̪oːni	wiki
manzoniano	män̪d̪͡z̪o̞n̺jäːn̺o̞	wiki
mappa	mäppä	wiki
mappamondo	mäppämo̞n̪d̪o	wiki
maracanazo	märäkänäːso	wiki
maracanaço	märäkänäːso	wiki
maramaldo	mär̺ämäl̪d̪o̞	wiki
marangone	märäŋɡoːne	wiki
marangoni	märäŋɡoːni	wiki
maranta	mär̺än̪t̪ä	wiki
marcio	martʃo	wiki
marco	mär̺ko̞	wiki
mare	mäːɾe	wiki
maremma	märemːä	wiki
maresciallo	mär̺e̞ʃʃäl̺l̺o̞	wiki
margarita	mär̺ɡär̺iːt̪ä	wiki
margherita	mär̺ɡ̟e̞r̺iːt̪ä	wiki
marijuana	mär̺iwäːn̺ä	wiki
marito	märiːt̪o	wiki
marocco	mär̺ɔkko	wiki
martedì	märt̪ed̪i	wiki
marzaiola	mär̺t̪͡s̪äjɔːl̺ä	wiki
marzo	mär̺t̪͡s̪o̞	wiki
mascarpone	mäs̪kär̺po̞ːn̺e	wiki
masgalano	mäz̪ɡäl̺äːn̺o̞	wiki
masnada	mäz̪n̺äːd̪ä	wiki
masochismo	mäz̪o̞k̟iz̪mo	wiki
massacro	mäs̪s̪äːkr̺o̞	wiki
massaggio	mäs̪s̪äd͡ːʒo	wiki
massimamente	mäs̪s̪imäme̞n̪t̪e	wiki
massime	mäs̪s̪ime	wiki
massimiliano	mäs̪s̪imil̺jäːn̺o̞	wiki
massimo	mäs̪s̪imo	wiki
mastaba	mäs̪t̪äbä	wiki
masticamento	mäs̪t̪ikäme̞n̪t̪o	wiki
masticare	mäs̪t̪ikäːr̺e̞	wiki
masticaticcio	mäs̪t̪ikät̪it͡ʃt͡ʃo	wiki
masticatura	mäs̪t̪ikät̪uːr̺ä	wiki
masticazione	mäs̪t̪ikät̪t̪͡s̪joːn̺e	wiki
mastoplastica	mäs̪t̪o̞pl̺äs̪t̪ikä	wiki
mastoplastico	mäs̪t̪o̞pl̺äs̪t̪iko	wiki
mastruca	mäs̪t̪r̺uːkä	wiki
masturbazione	mäs̪t̪ur̺bät̪̪t͡s̪joːn̺e	wiki
matilde	mät̪il̪d̪e	wiki
matre	mäːt̪r̺e	wiki
matrimo	mäːt̪r̺imo	wiki
matrimoniale	mät̪r̺imon̺jäːl̺e̞	wiki
matrimonio	mät̪r̺imɔːn̺jo	wiki
mattanza	mät̪t̪än̪t̪͡s̪ä	wiki
mattarello	mät̪t̪är̺ɛl̺l̺o	wiki
matterello	mät̪t̪e̞r̺ɛl̺l̺o	wiki
mattero	mät̪t̪e̞r̺o	wiki
mattina	mät̪t̪iːn̺ä	wiki
mattino	mat̪t̪iːno	wiki
matusalemme	mät̪uz̪äl̺ɛmme	wiki
mavì	mävi	wiki
mazzafionda	mät̪t̪͡s̪äfjon̪d̪ä	wiki
mazzafrusto	mät̪͡ːs̪äfr̺us̪t̪o	wiki
me'	mɛ	wiki
meare	meäːr̺e̞	wiki
meco	meːko	wiki
meda	meːd̪ä	wiki
meda	mɛːd̪ä	wiki
medesimo	med̪eːz̪imo	wiki
medesmo	med̪ez̪mo	wiki
mediante	med̪jän̪t̪e̞	wiki
mediare	med̪jäːre	wiki
medicastro	med̪ikäs̪t̪r̺o̞	wiki
medicatore	med̪ikäto̞ːr̺e	wiki
medicatrice	med̪ikätr̺iːt͡ʃe	wiki
mediceo	med̪iːt͡ʃeo	wiki
mediceo	med̪iːt͡ʃe̯o	wiki
medicina	medit͡ʃina	wiki
medieuropeo	med̪jeu̯r̺opɛːo	wiki
medioeuropeo	mɛd̪joeu̯r̺opɛːo	wiki
meditatore	med̪it̪ät̪o̞ːr̺e	wiki
meditatrice	med̪it̪ät̪r̺iːt͡ʃe	wiki
meditazione	med̪it̪at̪t̪͡s̪joːn̺e	wiki
medo	mɛːd̪o	wiki
meeting	miːt̪iŋɡ	wiki
mefistofele	mefis̪t̪ɔːfel̺e	wiki
mefistofelico	mefis̪t̪ofɛːl̺iko	wiki
melanoblastico	mɛl̺än̺o̞bl̺äs̪t̪iko	wiki
melanoblasto	mɛl̺än̺o̞bl̺äs̪t̪o̞	wiki
melassa	melassa	wiki
meliambo	mel̺jämbo̞	wiki
melodiare	mel̺od̪jäːr̺e̞	wiki
meloide	mel̺ɔi̯d̪e	wiki
melos	mɛːl̺os̪	wiki
memore	mɛːmor̺e	wiki
menare	men̺äːr̺e̞	wiki
mendace	men̪d̪äːt͡ʃe̞	wiki
mendacemente	men̪d̪at͡ʃemen̪t̪e	wiki
mendacio	men̪d̪äːt͡ʃo̞	wiki
mendelevio	men̪d̪el̺ɛːvjo	wiki
mentalità	mentalita	wiki
mentecatto	men̪t̪ekät̪ːo̞	wiki
mercare	mer̺käːr̺e̞	wiki
merce	mɛr̺t͡ʃe	wiki
mercoledì	mɛrkoled̪i	wiki
mercé	mer̺t͡ʃe	wiki
merda	mɛr̺d̪ä	wiki
merdaio	mer̺d̪äːjo	wiki
merito	mɛːr̺it̪o	wiki
merlango	mer̺l̺äŋɡo̞	wiki
merlano	mer̺l̺än̺o̞	wiki
merlano	mɛr̺l̺än̺o̞	wiki
merto	mɛr̺t̪o	wiki
mesiversario	mesiversäːrjo	wiki
mesiversario	meziversäːrjo	wiki
mesopotamia	mez̪opot̪äːmjä	wiki
mesopotamico	mez̪opot̪äːmiko	wiki
messaggiare	mes̪ːädd͡ʒäːr̺e̞	wiki
messe	mes̪s̪e	wiki
messe	mɛs̪s̪e	wiki
messere	mes̪s̪ɛːr̺e̞	wiki
messia	messiːa	wiki
messina	mes̪s̪iːn̺ä	wiki
mestierante	mes̪t̪jer̺än̪t̪e̞	wiki
mestolo	mes̪t̪ol̺o	wiki
metalinguaggio	mɛt̪äl̺iŋɡwädd͡ʒo̞	wiki
metalinguistica	mɛt̪äl̺iŋɡwis̪t̪ikä	wiki
metanfetamina	met̪äɱfe̞t̪ämiːn̺ä	wiki
metaplastico	mɛt̪äpl̺äs̪t̪iko	wiki
metempirico	met̪empiːr̺iko	wiki
metro	mɛːt̪r̺o	wiki
metrosessuale	mɛt̪r̺os̪es̪s̪wäːl̺e̞	wiki
mezzalana	mɛd̪d̪͡z̪äl̺äːn̺ä	wiki
mezzanità	med̪͡z̪d̪͡z̪än̺it̪ä	wiki
mezzena	med̪d̪͡z̪ɛːn̺ä	wiki
mezzobusto	mɛd̪d̪͡z̪obus̪t̪o	wiki
miagolare	mjäɡo̞l̺äːr̺e̞	wiki
miagolio	mjäɡo̞l̺io̯	wiki
miami	mäjɛːmi	wiki
miao	mjäo̯	wiki
micidiale	mit͡ʃid̪jäːl̺e̞	wiki
micidialmente	mit͡ʃid̪jäl̺me̞n̪t̪e	wiki
micidio	mit͡ʃiːd̪jo	wiki
micragna	mikr̺äɲɲä	wiki
microforgia	mikr̺ofɔr̺d͡ʒä	wiki
microsclerite	mikr̺os̪kl̺er̺iːt̪e	wiki
microsclero	mikr̺os̪kl̺ɛːr̺o	wiki
microsecondo	mikr̺os̪ekon̪d̪o	wiki
midollo	midollo	wiki
mieloblastico	mjel̺obl̺äs̪t̪iko	wiki
mieloblasto	mjel̺obl̺äs̪t̪o̞	wiki
mietitore	mjet̪it̪oːr̺e	wiki
mietitrebbia	mjet̪it̪r̺ebːjä	wiki
mietitrebbiatrice	mjet̪it̪r̺ebːjät̪r̺iːt͡ʃe	wiki
mignattaio	miɲɲät̪t̪äːjo	wiki
mignattino	miɲɲät̪t̪iːn̺o	wiki
mignottocrazia	miɲːɔt̪ːokr̺ät̪͡ːs̪iːä	wiki
migragna	miɡr̺äɲɲä	wiki
milena	mil̺ɛːn̺ä	wiki
mille	mil̺l̺e	wiki
millenne	mil̺l̺ɛn̺n̺e	wiki
millimetro	mil̺l̺iːmet̪r̺o	wiki
millisecondo	mil̺ːis̪ekon̪d̪o	wiki
miluogo	mil̺wɔːɡo	wiki
milza	mil̺t̪͡s̪ä	wiki
minchia	miŋk̟jä	wiki
minestrone	minest̪roːne	wiki
mingere	min̺ʲd͡ʒer̺e	wiki
minuire	min̺uiːr̺e	wiki
mio	miːo	wiki
mioplastico	mjopl̺äs̪t̪iko	wiki
mirmillone	mir̺mil̺l̺oːn̺e	wiki
miscela	miʃʃɛːla	wiki
miscredente	mis̪kr̺ed̪ɛn̪t̪e	wiki
miscredere	mis̪kr̺eːd̪er̺e	wiki
miseramente	miz̪er̺äme̞n̪t̪e	wiki
miseria	miz̪ɛːr̺jä	wiki
misero	miːz̪er̺o	wiki
miserrimo	miz̪ɛr̺r̺imo	wiki
mistella	mist̪ɛl̺ːä	wiki
mistrà	mis̪t̪r̺ä	wiki
mitena	mit̪ɛːn̺ä	wiki
mitizzare	mit̪id̪d̪͡z̪äːr̺e̞	wiki
mitizzazione	mit̪id̪d̪͡z̪ät̪͡s̪joːn̺e	wiki
mitteleuropeo	mit̪ːel̺eu̯r̺opɛːo	wiki
mittena	mit̪t̪ɛːn̺ä	wiki
miyagawa	mijäɡäːwä	wiki
modo	mɔːd̪o	wiki
moglie	moʎːe	wiki
molecola	mol̺ɛːkol̺ä	wiki
mollezza	mol̺l̺et̪t̪͡s̪ä	wiki
molo	mɔːl̺o	wiki
moltiplicando	mol̪t̪ipl̺ikän̪d̪o̞	wiki
molva	mɔl̺vä	wiki
monaco	mɔːnako	wiki
monarca	mon̺är̺kä	wiki
monarchia	mon̺är̺k̟iːä	wiki
monatto	monät̪ːo	wiki
mondeghino	mon̪d̪eɡ̟iːno	wiki
monferrato	moɱferːäːt̪o	wiki
monferrina	moɱferːiːnä	wiki
monferrino	moɱferːiːno	wiki
mongolfiera	moŋɡol̺fjɛːr̺ä	wiki
monoblastico	mon̺obl̺äs̪t̪iko	wiki
monoblasto	mon̺obl̺äs̪t̪o̞	wiki
monocristallo	mɔn̺okr̺is̪t̪äl̺ːo̞	wiki
monologare	mon̺ol̺o̞ɡaːr̺e̞	wiki
monologare	mɔn̺ol̺o̞ɡaːr̺e̞	wiki
monologo	mon̺ɔːl̺o̞ɡo	wiki
monosio	mon̺ɔːz̪jo	wiki
monotonia	mon̺ot̪on̺iːä	wiki
monottongazione	mon̺ot̪ːoŋɡät̪͡s̪joːn̺e	wiki
monottongo	mon̺ot̪t̪ɔŋɡo	wiki
monstro	mon̪s̪t̪r̺o	wiki
morale	mor̺äːl̺e̞	wiki
mortadella	mor̺t̪äd̪ɛl̺ːä	wiki
morte	mɔr̺t̪e	wiki
mortifero	mor̺t̪iːfer̺o	wiki
mosca	mos̪kä	wiki
mosco	mɔs̪ko	wiki
moscovia	mos̪kɔːvjä	wiki
moscoviano	mos̪kovjäːn̺o̞	wiki
moscovita	mos̪koviːt̪ä	wiki
mostro	mos̪t̪r̺o	wiki
motorcaravan	mot̪or̺käːr̺ävän̺	wiki
mouse	mäu̯s̪	wiki
mouse	mäu̯z̪	wiki
mozza	mot̪t̪͡s̪ä	wiki
mucillagine	mut͡ʃil̺l̺äːdʒin̺e	wiki
muda	muːd̪ä	wiki
mudare	mud̪äːr̺e̞	wiki
muftì	muft̪i	wiki
mugello	mud͡ʒɛl̺l̺o	wiki
mugginara	mudd͡ʒin̺äːr̺ä	wiki
muggine	mudd͡ʒin̺e	wiki
mugilide	mud͡ʒiːl̺id̪e	wiki
mugiliforme	mud͡ʒil̺ifor̺me	wiki
mugnaia	muɲɲäːjä	wiki
multicolore	mul̺t̪ikol̺oːr̺e	wiki
multiforme	mul̺t̪ifor̺me	wiki
multilingue	mul̺t̪il̺iŋɡwe	wiki
munerare	mun̺er̺äːr̺e̞	wiki
munerazione	mun̺er̺ät̪t̪͡s̪joːn̺e	wiki
mungere	mun̺ʲd͡ʒer̺e	wiki
munificente	mun̺ifit͡ʃɛn̪t̪e	wiki
munificenza	mun̺ifit͡ʃɛn̪t̪͡s̪ä	wiki
muno	muːn̺o	wiki
muraglia	mur̺äʎʎä	wiki
muraglione	mur̺äʎʎo̞ːn̺e	wiki
murale	mur̺aːl̺e	wiki
muramento	mur̺äme̞n̪t̪o	wiki
muro	muːr̺o	wiki
musa	muːz̪ä	wiki
muscolomembranoso	mus̪kol̺omembr̺än̺o̞ːz̪o	wiki
musicale	muz̪ikäːl̺e̞	wiki
musiche	muːzike	wiki
musino	muz̪iːn̺o	wiki
musino	muːz̪in̺o	wiki
musmè	muz̪mɛ	wiki
mutacismo	mut̪at͡ʃiz̪mo	wiki
mutare	mut̪äːr̺e̞	wiki
mutazilismo	mut̪äd̪͡z̪il̺iz̪mo	wiki
mutazilita	mut̪äd̪͡z̪il̺iːt̪ä	wiki
mutilo	muːt̪il̺o	wiki
mutuo	muːt̪wo	wiki
nababbo	n̺äbäbːo̞	wiki
nabla	n̺äːbl̺ä	wiki
nablo	n̺äːbl̺o̞	wiki
nano	n̺äːn̺o̞	wiki
nanosecondo	n̺än̺o̞s̪ekon̪d̪o	wiki
napoleone	n̺äpo̞l̺e̯oːn̺e	wiki
napoletanismo	näpolet̪änizmo	wiki
napoletanità	näpolet̪änit̪ä	wiki
napoletano	näpolet̪äːno	wiki
napoli	näːpoli	wiki
nappare	n̺äppäːr̺e̞	wiki
nappo	n̺äppo̞	wiki
nare	n̺äːr̺e̞	wiki
nari	n̺äːr̺i	wiki
narrative	narrat̪iːve	wiki
narrativo	narrat̪iːvo	wiki
nascere	n̺äʃʃe̞r̺e	wiki
nascondimento	n̺äs̪ko̞n̪d̪imen̪t̪o	wiki
nastia	n̺äs̪t̪iä̯	wiki
nastia	n̺äs̪t̪iːä	wiki
natante	n̺ät̪än̪t̪e̞	wiki
natare	n̺ät̪äːr̺e̞	wiki
natatore	n̺ät̪ät̪o̞ːr̺e	wiki
natatrice	n̺ät̪ät̪r̺iːt͡ʃe	wiki
nato	n̺äːt̪o̞	wiki
natrice	n̺ät̪r̺iːt͡ʃe	wiki
naufragio	n̺äu̯fr̺äːd͡ʒo̞	wiki
nautico	n̺äu̯t̪iko	wiki
navale	n̺äväːl̺e̞	wiki
navalestro	n̺äväl̺ɛs̪t̪r̺o	wiki
nave	n̺äːve̞	wiki
nazianzeno	n̺äd̪͡z̪jän̪d̪͡z̪ɛːn̺o	wiki
nazianzo	n̺äd̪͡z̪ːjän̪d̪͡z̪o	wiki
nazireato	n̺äd̪͡z̪ir̺e̯äːt̪o̞	wiki
nazireo	n̺äd̪͡z̪ir̺ɛːo	wiki
nazista	näd̪͡ːz̪ist̪ä	wiki
nazista	nät̪͡ːs̪ist̪ä	wiki
naïf	n̺äif	wiki
nebbia	nebbja	wiki
nebbiolo	nebːjɔːlo	wiki
nebel	n̺ɛːbel̺	wiki
necessario	n̺et͡ʃes̪s̪aːr̺jo	wiki
necesse	n̪et͡ʃɛs̪s̪e	wiki
necrobiosi	n̺ekr̺obiɔːz̪i	wiki
necrobiotico	n̺ekr̺obiɔːt̪iko	wiki
necrofagia	n̺ekr̺ofäd͡ʒiä̯	wiki
necrofagico	n̺ekr̺ofäːd͡ʒiko	wiki
necrofago	n̺ekr̺ɔːfäɡo̞	wiki
necrofila	n̺ekr̺ɔːfil̺ä	wiki
necrofilia	n̺ekr̺ofil̺iä̯	wiki
necrofilo	n̺ekr̺ɔːfil̺o	wiki
necrofito	n̺ekr̺ɔːfit̪o	wiki
necrofoba	n̺ekr̺ɔːfobä	wiki
necrofobia	n̺ekr̺ofobiä̯	wiki
necrofobico	n̺ekr̺ofɔːbiko	wiki
necrofobo	n̺ekr̺ɔːfobo	wiki
necroforo	n̺ekr̺ɔːfor̺o	wiki
necrolisi	n̺ekr̺ɔːl̺iz̪i	wiki
necrologia	n̺ekr̺ol̺od͡ʒiä̯	wiki
necrologico	n̺ekr̺ol̺ɔːd͡ʒiko	wiki
necrologio	n̺ekr̺ol̺ɔːd͡ʒo	wiki
necrologista	n̺ekr̺ol̺od͡ʒis̪t̪ä	wiki
necromante	n̺ekr̺omän̪t̪e̞	wiki
necromanzia	n̺ekr̺omän̪t̪͡s̪iä̯	wiki
necropoli	n̺ekr̺ɔːpol̺i	wiki
necropsia	n̺ekr̺ops̪iä̯	wiki
necrormone	n̺ekr̺or̺moːn̺e	wiki
necroscopia	n̺ekr̺os̪kopiä̯	wiki
necroscopico	n̺ekr̺os̪kɔːpiko	wiki
necroscopo	n̺ekr̺ɔs̪kopo	wiki
necrosi	n̺ekr̺ɔːz̪i	wiki
necrosi	n̺ɛːkr̺oz̪i	wiki
necrospermia	n̺ekr̺os̪per̺miä̯	wiki
necrotico	n̺ekr̺ɔːt̪iko	wiki
necrotizzare	n̺ekr̺ot̪id̪d̪͡z̪äːr̺e̞	wiki
necrotomia	n̺ekr̺ot̪omiä̯	wiki
necrotrofia	n̺ekr̺ot̪r̺ofiä̯	wiki
necrotrofismo	n̺ekr̺ot̪r̺ofiz̪mo	wiki
necrotrofo	n̺ekr̺ɔːt̪r̺ofo	wiki
nectozoide	n̺ekt̪od̪͡z̪ɔi̯d̪e	wiki
negro	n̺eːɡr̺o	wiki
negromante	n̺eɡr̺omän̪t̪e̞	wiki
negromanzia	n̺eɡr̺omän̪t̪͡s̪iä̯	wiki
negus	n̺ɛːɡus̪	wiki
negussita	n̺eɡus̪s̪iːt̪ä	wiki
nematoblastico	n̺emät̪o̞bl̺äs̪t̪iko	wiki
nembrot	n̺embr̺ɔt̪	wiki
nembrotto	n̺embr̺ɔt̪t̪o	wiki
nemmanco	n̺emmäŋko̞	wiki
neogreco	n̺ɛo̯ɡr̺ɛːko	wiki
neon	n̺ɛːon̺	wiki
neon	n̺ɛːɔn̺	wiki
nepote	n̺epoːt̪e	wiki
nerbo	nɛrbo	wiki
nessuno	nesːuːno	wiki
nettare	n̺et̪t̪äːr̺e̞	wiki
nettare	n̺ɛt̪t̪är̺e̞	wiki
nettareo	n̺et̪t̪äːr̺e̞o̯	wiki
nettari	n̺et̪t̪äːr̺i	wiki
nettari	n̺ɛt̪t̪är̺i	wiki
nettarino	n̺et̪t̪är̺iːn̺o	wiki
nettario	n̺et̪t̪äːr̺jo	wiki
nettarivoro	n̺et̪t̪är̺iːvor̺o	wiki
nettaroconca	n̺et̪t̪är̺o̞koŋkä	wiki
nettarofago	n̺et̪t̪är̺ɔːfäɡo̞	wiki
nettaroteca	n̺et̪t̪är̺o̞t̪ɛːkä	wiki
nettarovia	n̺et̪t̪är̺o̞viä̯	wiki
nettozoide	n̺et̪t̪od̪͡z̪ɔi̯d̪e	wiki
nettuno	net̪t̪uːno	wiki
neuno	n̺euːn̺o	wiki
neuroscheletro	n̺ɛu̯r̺os̪kɛːl̺et̪r̺o	wiki
nevaio	n̺eväːjo̞	wiki
nevare	n̺eväːr̺e̞	wiki
nevato	n̺eväːt̪o̞	wiki
neve	n̺eːve	wiki
nevicare	n̺evikäːr̺e̞	wiki
nevicata	n̺evikäːt̪ä	wiki
neviera	n̺evjɛːr̺ä	wiki
nevischiare	n̺evis̪kjäːr̺e̞	wiki
nevischio	n̺evis̪kjo	wiki
nevosità	n̺evoz̪it̪ä	wiki
nevoso	n̺evoːz̪o	wiki
nicciano	nit͡ːʃäːno	wiki
nico	n̺iːko	wiki
nicticora	nikt̪iːkor̺ä	wiki
nictinastia	n̺ikt̪in̺äs̪t̪iä̯	wiki
nictinastia	n̺ikt̪in̺äs̪t̪iːä	wiki
nictinastico	n̺ikt̪in̺äs̪t̪iko	wiki
nidiandolo	n̺id̪jän̪d̪o̞l̺o	wiki
niente	n̺jɛn̪t̪e	wiki
nientedimeno	n̺jen̪t̪ed̪imeːn̺o	wiki
nientepopodimeno	n̺jen̪t̪epopod̪imeːn̺o	wiki
nietzschianesimo	nit͡ːʃäneːzimo̞	wiki
nietzschiano	nit͡ːʃäːno	wiki
nievo	n̺jɛːvo	wiki
night	n̺ai̯t̪	wiki
nilde	n̺il̪d̪e	wiki
nilo	n̺iːl̺o	wiki
nilota	n̺il̺ɔːt̪ä	wiki
nilotico	n̺il̺ɔːt̪iko	wiki
nimo	n̺iːmo	wiki
ninja	n̺in̺ʲd͡ʒä	wiki
nipote	n̺ipoːt̪e	wiki
nippofilia	nipːofiliːä	wiki
nisseno	nisːɛːno	wiki
nitrobenzene	n̺it̪r̺oben̪d̪͡z̪ɛːn̺e	wiki
nitrobenzolo	n̺it̪r̺oben̪d̪͡z̪ɔːl̺o	wiki
nitrosare	n̺it̪r̺oz̪äːr̺e̞	wiki
nitticora	nit̪t̪iːkor̺ä	wiki
niuno	n̺iuːn̺o	wiki
nivale	n̺iväːl̺e̞	wiki
niveo	n̺iːveo̯	wiki
nizioleto	n̺it̪͡ːs̪jol̺eːt̪o	wiki
nizza	nit̪͡s̪ːä	wiki
nizzardo	nit̪͡ːs̪är̪d̪o	wiki
nizzese	nit̪͡ːs̪eːse	wiki
nizzese	nit̪͡ːs̪eːze	wiki
nobel	nobɛl̺	wiki
nobel	nɔːbel̺	wiki
nobilitade	n̺obil̺it̪äːd̪e̞	wiki
nobilitate	n̺obil̺it̪äːt̪e̞	wiki
nobilità	n̺obil̺it̪ä	wiki
nobiltà	n̺obil̪t̪ä	wiki
nocciola	n̺ot͡ːʃɔːl̺ä	wiki
nocciuola	n̺ot͡ːʃwɔːl̺ä	wiki
nocente	n̺ot͡ʃɛn̪t̪e	wiki
nocivamente	n̺ot͡ʃiväme̞n̪t̪e	wiki
nocività	n̺ot͡ʃivit̪ä	wiki
nocivo	n̺ot͡ʃiːvo	wiki
nocumento	n̺okumen̪t̪o	wiki
nocuo	n̺ɔːkwo	wiki
noia	n̺ɔːjä	wiki
nome	n̺oːme	wiki
non	non	wiki
nonagesimo	n̺on̺äd͡ʒe̞ːz̪imo	wiki
nonviolento	n̺oɱvjol̺ɛn̪t̪o	wiki
nonviolenza	n̺oɱvjol̺ɛn̪t̪͡s̪ä	wiki
nordide	n̺ɔr̺d̪id̪e	wiki
nordirlandese	n̺or̺d̪ir̺l̺än̪d̪eːz̪e	wiki
norreno	n̺or̺r̺ɛːn̺o	wiki
norvegese	n̺or̺ved͡ʒeːz̪e	wiki
nosco	n̺ɔs̪ko	wiki
nosocomiale	noz̪okomjäːl̺e	wiki
nosocomio	noz̪okɔːmjo	wiki
nossale	n̺os̪s̪äːl̺e̞	wiki
nottola	nɔt̪ːolä	wiki
notturno	not̪ːurno	wiki
noumenico	noumɛːniko̞	wiki
noumenico	nou̯mɛːniko̞	wiki
noumeno	nouːmeno	wiki
nova	n̺ɔːvä	wiki
nove	n̺ɔːve	wiki
novella	n̺ovɛl̺l̺ä	wiki
novellare	n̺ovel̺l̺äːr̺e	wiki
novembre	n̺ovɛmbr̺e	wiki
noverca	n̺ovɛr̺kä	wiki
novitade	n̺ovit̪äːd̪e̞	wiki
novitate	n̺ovit̪äːt̪e̞	wiki
novità	n̺ovit̪ä	wiki
novizio	n̺ovit̪͡ːs̪jo	wiki
novo	n̺ɔːvo	wiki
nuba	n̺uːbä	wiki
nubendo	n̺ubɛn̪d̪o	wiki
nuca	n̺uːkä	wiki
nullo	n̺ul̺l̺o	wiki
numero	n̺uːmer̺o	wiki
nun	n̺un̺	wiki
nundine	n̺un̪d̪in̺e	wiki
nuocere	n̺wɔːt͡ʃer̺e	wiki
nuotare	nwotare	wiki
nuovo	n̺wɔːvo	wiki
nutante	n̺ut̪än̪t̪e̞	wiki
nutazione	n̺ut̪at̪t̪͡s̪joːn̺e	wiki
nuto	n̺uːt̪o	wiki
nuvola	n̺uːvol̺ä	wiki
nì	n̺i	wiki
obblioso	obbl̺ioːz̪o	wiki
obblivione	obbl̺ivjoːn̺e	wiki
obbrobrio	obbr̺ɔːbr̺jo	wiki
obbrobriosità	obbr̺obr̺joz̪it̪ä	wiki
obbrobrioso	obbr̺obr̺joːz̪o	wiki
obeso	obɛːz̪o	wiki
obi	ɔːbi	wiki
oblioso	obl̺ioːz̪o	wiki
oblivione	obl̺ivjoːn̺e	wiki
oboe	ɔːboe	wiki
oboe	ɔːbo̯e	wiki
oboè	oboɛ	wiki
oboè	obo̯ɛ	wiki
oca	ɔka	wiki
occhiale	okk̟jäːle	wiki
occhiali	okk̟jäːli	wiki
occhiazzurro	okkjäd̪d̪͡z̪ur̺r̺o	wiki
occhiceruleo	okk̟it͡ʃe̪r̺uːl̺e̯o	wiki
occhione	okkjoːn̺e	wiki
occidentalizzare	ott͡ʃid̪en̪t̪al̺id̪d̪͡z̪aːr̺e	wiki
occidentalizzarsi	ott͡ʃid̪en̪t̪al̺id̪d̪͡z̪ar̺s̪i	wiki
occidentalizzazione	ott͡ʃid̪en̪t̪al̺id̪d̪͡z̪at̪͡s̪joːn̺e	wiki
occidente	ott͡ʃid̪ɛn̪t̪e	wiki
occidere	ott͡ʃiːd̪er̺e	wiki
occorrere	okkor̺r̺er̺e	wiki
occulto	okkul̺t̪o	wiki
oceania	ot͡ʃeäːn̺jä	wiki
oceaniano	ot͡ʃeän̺jäːn̺o̞	wiki
oceanino	ot͡ʃeän̺iːn̺o	wiki
oculo	ɔːkul̺o	wiki
odiabile	od̪jäːbil̺e	wiki
odiare	od̪jäːr̺e̞	wiki
odiarsi	od̪jär̺s̪i	wiki
odiato	od̪jäːt̪o̞	wiki
odiatore	od̪jät̪o̞ːr̺e	wiki
odiatrice	od̪jät̪r̺iːt͡ʃe	wiki
odibile	od̪iːbil̺e	wiki
odio	ɔːd̪jo	wiki
odiosaggine	od̪joz̪ädd͡ʒin̺e	wiki
odiosamato	od̪joz̪ämäːt̪o̞	wiki
odiosamente	od̪joz̪äme̞n̪t̪e	wiki
odiosità	od̪joz̪it̪ä	wiki
odioso	od̪joːz̪o	wiki
odocelo	od̪ot͡ʃɛːl̺o	wiki
odocoileo	od̪okoi̯l̺ɛːo	wiki
odontoblastico	od̪on̪t̪obl̺äs̪t̪iko	wiki
odor	od̪or̺	wiki
odorante	od̪or̺än̪t̪e̞	wiki
odorare	od̪or̺äːr̺e̞	wiki
odorato	od̪or̺äːt̪o̞	wiki
odore	od̪oːr̺e	wiki
odorifero	od̪or̺iːfer̺o	wiki
odorimetria	od̪or̺imet̪r̺iːä	wiki
odorimetro	od̪or̺iːmet̪r̺o	wiki
odorino	od̪or̺iːn̺o	wiki
odorino	od̪oːr̺in̺o	wiki
odorista	od̪or̺is̪t̪ä	wiki
odorivettore	od̪or̺ivet̪t̪oːr̺e	wiki
odorizzante	od̪or̺id̪d̪͡z̪än̪t̪e̞	wiki
odorizzare	od̪or̺id̪d̪͡z̪äːr̺e̞	wiki
odorizzazione	od̪or̺id̪d̪͡z̪ät̪t̪͡s̪joːn̺e	wiki
odoroforo	od̪or̺ɔːfor̺o	wiki
odoroso	od̪or̺oːz̪o	wiki
officio	ofːiːt͡ʃo	wiki
oggimai	od͡ːʒimäi̯	wiki
ogne	oɲɲe	wiki
ogni	oɲːi	wiki
ogni	ɔɲːi	wiki
ognitempo	oɲɲit̪ɛmpo	wiki
ognuna	oɲːuːnä	wiki
ognuno	oɲːuːno	wiki
oleandolo	ol̺e̯än̪d̪o̞l̺o	wiki
oleato	ol̺e̯äːt̪o̞	wiki
olente	ol̺ɛn̪t̪e	wiki
olezzante	ol̺ed̪d̪͡z̪än̪t̪e̞	wiki
olezzare	ol̺ed̪d̪͡z̪äːr̺e̞	wiki
olezzo	ol̺ed̪d̪͡z̪o	wiki
olfattia	ol̺fat̪t̪iːä	wiki
olfattivo	ol̺fat̪t̪iːvo	wiki
olfatto	ol̺fät̪t̪o̞	wiki
olfattometria	ol̺fat̪t̪omet̪r̺iːä	wiki
olfattometro	ol̺fat̪t̪ɔːmet̪r̺o	wiki
olfattorio	ol̺fät̪t̪ɔːr̺jo	wiki
oliandola	ol̺jän̪d̪o̞l̺ä	wiki
oliandolo	ol̺jän̪d̪o̞l̺o	wiki
oliare	ol̺jäːr̺e̞	wiki
oliario	ol̺jäːr̺jo	wiki
oliata	ol̺jäːt̪ä	wiki
oliatina	ol̺jät̪iːn̺ä	wiki
oliatore	ol̺jät̪o̞ːr̺e	wiki
oligarca	ol̺iɡär̺kä	wiki
oligarchia	ol̺iɡär̺k̟iːä	wiki
oligarchicamente	ol̺iɡär̺k̟ikäme̞n̪t̪e	wiki
oligarchico	ol̺iɡär̺k̟iko	wiki
olire	ol̺iːr̺e	wiki
oloblastico	ol̺obl̺äs̪t̪iko	wiki
olore	ol̺oːr̺e	wiki
oltra	ol̪t̪r̺ä	wiki
oltracciò	ol̪t̪r̺ätt͡ʃɔ	wiki
oltramontano	ol̺t̪r̺ämo̞n̪t̪äːn̺o̞	wiki
oltre	ol̪t̪r̺e	wiki
omai	omäi̯	wiki
ombelico	ombel̺iːko	wiki
ombra	ombr̺ä	wiki
omero	ɔːmer̺o	wiki
omertosamente	omert̪osämen̪t̪e	wiki
omertosamente	omert̪ozämen̪t̪e	wiki
omertoso	omert̪oːso	wiki
omertoso	omert̪oːzo	wiki
omertà	omert̪ä	wiki
ometto	omet̪ːo	wiki
omicidiale	omit͡ʃid̪jäːl̺e̞	wiki
omicidio	omit͡ʃiːd̪jo	wiki
ominazione	omin̺ät̪t̪͡s̪joːn̺e	wiki
omini	omiːn̺i	wiki
omini	ɔːmin̺i	wiki
omino	omiːn̺o	wiki
ominoso	omin̺oːz̪o	wiki
omo	ɔːmo	wiki
omone	omoːn̺e	wiki
omoplastico	ɔmopl̺äs̪t̪iko	wiki
oncia	on̺ʲt͡ʃä	wiki
onciario	on̺ʲt͡ʃäːr̺jo	wiki
onde	on̪d̪e	wiki
ondeché	on̪d̪ek̟e	wiki
ondisono	on̪d̪iːson̺o	wiki
onere	ɔːn̺er̺e	wiki
onne	ɔn̺n̺e	wiki
onni	ɔn̺n̺i	wiki
onnipossente	on̺n̺ipos̪s̪ɛn̪t̪e	wiki
onnipotente	on̺ːipot̪ɛn̪t̪e	wiki
onnipotenti	on̺ːipot̪ɛn̪t̪i	wiki
onnisciente	on̺n̺iʃʃɛn̪t̪e	wiki
onoranza	on̺or̺än̪t̪͡s̪ä	wiki
onorare	on̺or̺äːr̺e̞	wiki
onorato	on̺or̺äːt̪o̞	wiki
onranza	on̺r̺än̪t̪͡s̪ä	wiki
onrare	on̺r̺äːr̺e̞	wiki
onrato	on̺r̺äːt̪o̞	wiki
onta	on̪t̪ä	wiki
ontoso	on̪t̪oːz̪o	wiki
onusto	on̺us̪t̪o	wiki
opelanda	opelän̪d̪ä	wiki
opimo	opiːmo	wiki
oppilazione	oppil̺ät̪t̪͡s̪joːn̺e	wiki
oppio	ɔppjo	wiki
opprobrio	oppr̺ɔːbr̺jo	wiki
ora	oːr̺ä	wiki
ora	ɔːr̺ä	wiki
orante	or̺än̪t̪e̞	wiki
orare	or̺äːr̺e̞	wiki
orata	or̺äːt̪ä	wiki
orato	or̺äːt̪o̞	wiki
oratore	or̺ät̪oːr̺e	wiki
orazione	or̺ät̪t̪͡s̪joːn̺e	wiki
orbace	or̺bäːt͡ʃe̞	wiki
orbace	ɔr̺bäːt͡ʃe̞	wiki
orcio	or̺t͡ʃo	wiki
orco	ɔr̺ko	wiki
organizzarsi	or̺ɡän̺id̪d̪͡z̪är̺s̪i	wiki
organoide	or̺ɡän̺ɔi̯d̪e	wiki
orgia	ɔr̺d͡ʒä	wiki
orgoglioso	orɡoʎːoːso	wiki
orgoglioso	orɡoʎːoːzo	wiki
orichiomato	or̺ik̟jomäːt̪o̞	wiki
oricrinito	or̺ikr̺in̺iːt̪o	wiki
oriente	or̺jɛn̪t̪e	wiki
origami	oriɡäːmi	wiki
origami	oriːɡämi	wiki
origano	or̺iːɡän̺o̞	wiki
oriolo	or̺jɔːl̺o	wiki
oriuolo	or̺jwɔːl̺o	wiki
orneblenda	or̺n̺ebl̺ɛn̪d̪ä	wiki
orneblendite	or̺n̺ebl̺en̪d̪iːt̪e	wiki
ornitorinco	or̺n̺it̪or̺iŋko	wiki
oro	ɔːr̺o	wiki
orologeria	or̺ol̺od͡ʒer̺iä̯	wiki
orologiaio	or̺ol̺od͡ʒäːjo	wiki
orologiero	or̺ol̺od͡ʒɛːr̺o	wiki
orranza	or̺r̺än̪t̪͡s̪ä	wiki
orrare	or̺r̺äːr̺e̞	wiki
orrato	or̺r̺äːt̪o̞	wiki
orrendo	or̺r̺ɛn̪d̪o	wiki
orrire	or̺r̺iːr̺e	wiki
orsa	orsa	wiki
orsacchio	or̺s̪äkk̟jo	wiki
orsacchiotto	or̺s̪äkk̟jɔt̪t̪o	wiki
ortatoria	or̺t̪ät̪ɔːr̺jä	wiki
ortatorio	or̺t̪ät̪ɔːr̺jo	wiki
orticello	or̺t̪it͡ʃɛl̺l̺o	wiki
orto	ɔr̺t̪o	wiki
orzaiolo	or̺d̪͡z̪äjɔːl̺o	wiki
osare	oz̪äːr̺e̞	wiki
osco	ɔs̪ko	wiki
osculare	os̪kul̺äːr̺e̞	wiki
osculatore	os̪kul̺ät̪o̞ːr̺e	wiki
osculazione	os̪kul̺ät̪t̪͡s̪joːn̺e	wiki
osculo	ɔs̪kul̺o	wiki
oscurarsi	os̪kur̺ar̺s̪i	wiki
oscurati	os̪kur̺aːt̪i	wiki
oscurati	os̪kuːr̺at̪i	wiki
oscurità	os̪kur̺it̪a	wiki
osio	ɔːz̪jo	wiki
ossalico	os̪s̪äːl̺iko	wiki
ossalile	os̪s̪äl̺iːl̺e	wiki
ossidrico	os̪s̪iːd̪r̺iko	wiki
ossigeno	osːiːd͡ʒen̺o	wiki
osso	ɔsːo	wiki
ossobuco	ɔsːobuːko	wiki
ostello	os̪t̪ɛl̺l̺o	wiki
osteria	osteria	wiki
osterlicchi	os̪t̪er̺l̺ikk̟i	wiki
otaku	ot̪äːku	wiki
otoconio	ot̪okɔːn̺jo	wiki
otre	oːt̪r̺e	wiki
otta	ɔt̪ːä	wiki
ottagono	ot̪t̪aːɡon̺o	wiki
ottagono	ɔt̪t̪aːɡon̺o	wiki
ottangolo	ot̪t̪äŋɡo̞l̺o	wiki
ottenne	ot̪t̪en̺n̺e	wiki
ottenne	ot̪t̪ɛn̺n̺e	wiki
otto	ɔt̪t̪o	wiki
ottobrare	ot̪t̪obr̺äːr̺e̞	wiki
ottobre	ot̪t̪oːbr̺e	wiki
ottocentoquarantuno	ot̪t̪ot͡ʃɛn̪t̪okwär̺än̪t̪uːn̺o	wiki
ottriare	ot̪t̪r̺iäːr̺e̞	wiki
ove	oːve	wiki
ovest	ɔːves̪t̪	wiki
ovunque	ovuŋkwe	wiki
paba	päːbä	wiki
pabulo	päːbul̺o	wiki
pacchebotto	päkk̟e̞bɔt̪t̪o	wiki
pace	päːt͡ʃe̞	wiki
padiscià	pad̪iʃa	wiki
padiscià	pad̪iʃʃa	wiki
padre	päːd̪r̺e̞	wiki
paesucolo	päe̯̞z̪uːkol̺o	wiki
pagliaccio	päʎːät͡ʃːo	wiki
paio	päːjo	wiki
paladino	päl̺äd̪iːn̺o	wiki
palagio	päl̺äːd͡ʒo̞	wiki
palandra	pälän̪d̪rä	wiki
palandrana	pälän̪d̪räːnä	wiki
palandrano	pälän̪d̪räːno	wiki
palatoalveolare	päl̺ät̪oäl̺veol̺äːr̺e	wiki
palatoalveolare	päl̺ät̪o̯äl̺ve̯ol̺äːr̺e	wiki
palazzo	päl̺ät̪͡ːs̪o	wiki
paleomagnetismo	päl̺e̯omäɲɲet̪iz̪mo	wiki
pali	päːl̺i	wiki
palinsesto	päl̺in̪s̪ɛs̪t̪o	wiki
palio	päːl̺jo̞	wiki
pallio	päl̺l̺jo̞	wiki
pallone	palloːne	wiki
pallore	päl̺l̺oːr̺e	wiki
pallottoliere	pal̺l̺ot̪͡t̪͡ol̺i̯ɛːr̺e	wiki
palombaccio	päl̺o̞mbätt͡ʃo̞	wiki
palombo	päl̺o̞mbo	wiki
panatenee	pan̺at̪e̞n̺ɛːe̞	wiki
panca	päŋkä	wiki
pancarrè	päŋkärːɛ	wiki
pancarré	päŋkärːe	wiki
pancia	pän̺ʲt͡ʃä	wiki
panciuto	pän̺ʲt͡ʃuːt̪o	wiki
panda	pän̪d̪ä	wiki
pandoro	pän̪d̪ɔːro	wiki
pane	päːn̺e̞	wiki
panenteismo	pän̺e̞n̪t̪ei̯z̪mo	wiki
panettone	pänet̪ːoːne	wiki
panico	pän̺iːko	wiki
panico	päːn̺iko	wiki
pannelbagio	pän̺n̺e̞l̺bäːd͡ʒo̞	wiki
pannocchia	pän̺n̺ɔkkjä	wiki
pannoso	pän̺n̺oːz̪o	wiki
panoplia	pän̺ɔːpl̺jä	wiki
pantalone	pän̪t̪äl̺o̞ːn̺e	wiki
pantano	pän̪t̪äːn̺o̞	wiki
pantoclastia	pän̪t̪o̞kl̺äs̪t̪iä̯	wiki
pantoclastia	pän̪t̪o̞kl̺äs̪t̪iːä	wiki
pantoclastico	pän̪t̪o̞kl̺äs̪t̪iko	wiki
pantocratore	pan̪t̪okr̺aːt̪or̺e	wiki
papa	paːpa	wiki
paparazzo	päpärät̪͡ːs̪o	wiki
papera	päːpe̞r̺ä	wiki
papero	päːpe̞r̺o	wiki
paperopolese	päperopoleːse	wiki
paperopolese	päperopoleːze	wiki
pappagorgia	päppäɡɔr̺d͡ʒä	wiki
parabola	pär̺äːbo̞l̺ä	wiki
paradossastico	pär̺äd̪o̞s̪s̪äs̪t̪iko	wiki
parafernale	pär̺äfe̞r̺n̺äːl̺e̞	wiki
parafulmine	pär̺äful̺min̺e	wiki
paragoge	par̺aɡɔːd͡ʒe	wiki
parastico	pär̺äs̪t̪iko	wiki
paretone	pär̺e̞t̪oːn̺e	wiki
pargolo	parɡolo	wiki
parlamento	pär̺l̺äme̞n̪t̪o	wiki
parlare	pär̺l̺äːr̺e̞	wiki
parmigiana	pär̺mid͡ʒäːn̺ä	wiki
parricidio	pär̺r̺it͡ʃiːd̪jo	wiki
parrucca	parrukka	wiki
parruccheria	pär̺r̺ukker̺iä̯	wiki
parrucchiere	pär̺r̺ukk̟jɛːr̺e	wiki
particella	pär̺t̪it͡ʃɛl̺l̺ä	wiki
parvolezza	pär̺vo̞l̺et̪t̪͡s̪ä	wiki
parvolo	pär̺vo̞l̺o	wiki
pascale	päs̪käːl̺e̞	wiki
pascià	päʃʃä	wiki
pasifae	päs̪iːfäe̞	wiki
pasife	päs̪iːfe	wiki
pasquale	päs̪kwäːl̺e̞	wiki
passacaglia	päsːäkäʎːä	wiki
passive	passiːve	wiki
passo	passo	wiki
pasticcio	päs̪t̪it͡ːʃo	wiki
pasticciotto	päs̪t̪it͡ːʃɔt̪ːo	wiki
pastrocchio	päs̪t̪r̺ɔkk̟jo	wiki
patataia	pät̪ät̪äːjä	wiki
patataio	pät̪ät̪äːjo	wiki
patre	päːt̪r̺e̞	wiki
patrimo	päːt̪r̺imo	wiki
pattino	pät̪t̪in̺o	wiki
pattino	pät̪t̪iːn̺o	wiki
paura	päuːr̺ä	wiki
paventare	päve̞n̪t̪äːr̺e̞	wiki
pavento	pävɛn̪t̪o	wiki
pavera	pävɛːr̺ä	wiki
paviera	pävjɛːr̺ä	wiki
pavone	pävo̞ːn̺e	wiki
pavoneggiarsi	pävo̞n̺edd͡ʒär̺s̪i	wiki
pavonesco	pävo̞n̺es̪ko	wiki
pavore	pävo̞ːr̺e	wiki
peana	peäːn̺ä	wiki
peccare	pekkäːr̺e̞	wiki
pecchia	pekk̟jä	wiki
pecuglio	pekuʎʎo	wiki
peculio	pekuːl̺jo	wiki
pedio	pɛːd̪jo	wiki
pedissequo	ped̪is̪s̪ekwo	wiki
pedo	pɛːd̪o	wiki
pedone	ped̪oːne	wiki
pelago	pɛːl̺äɡo̞	wiki
pelanda	pelän̪d̪ä	wiki
pelandra	pelän̪d̪rä	wiki
pellanda	pelːän̪d̪ä	wiki
pelle	pelle	wiki
pelle	pɛlle	wiki
pellegrino	pel̺l̺eɡr̺iːn̺o	wiki
pelta	pɛl̪t̪ä	wiki
peltato	pel̪t̪äːt̪o̞	wiki
pena	peːna	wiki
pendaglio	pen̪d̪äʎːo	wiki
pene	peːne	wiki
pene	pɛːn̺e	wiki
penico	pɛːn̺iko	wiki
pensionare	pen̪s̪jon̺äːr̺e̞	wiki
pensione	pen̪s̪joːn̺e	wiki
pentagono	pen̪t̪aːɡon̺o	wiki
pentastellato	pɛn̪t̪äst̪elːäːt̪o	wiki
pentastico	pen̪t̪äs̪t̪iko	wiki
pentola	pen̪t̪ol̺ä	wiki
pentolaccia	pen̪t̪ol̺ätt͡ʃä	wiki
peone	peoːn̺e	wiki
pepe	peːpe	wiki
percentile	per̺t͡ʃen̪t̪iːl̺e	wiki
perennare	per̺en̺n̺äːr̺e̞	wiki
perento	per̺ɛn̪t̪o	wiki
perfezionanda	per̺fet̪t̪͡s̪jon̺än̪d̪ä	wiki
perfezionando	per̺fet̪t̪͡s̪jon̺än̪d̪o̞	wiki
pergiura	per̺d͡ʒuːr̺ä	wiki
pergiurare	per̺d͡ʒur̺äːr̺e̞	wiki
pergiurio	per̺d͡ʒuːr̺jo	wiki
pergiuro	per̺d͡ʒuːr̺o	wiki
periblastico	per̺ibl̺äs̪t̪iko	wiki
periblasto	per̺ibl̺äs̪t̪o̞	wiki
periglio	per̺iʎʎo	wiki
perigliosamente	per̺iʎʎoz̪äme̞n̪t̪e	wiki
periglioso	per̺iʎʎoz̪o	wiki
perire	perire	wiki
perita	per̺iːt̪ä	wiki
perito	per̺iːt̪o	wiki
periuro	per̺juːr̺o	wiki
permalosità	permälosit̪ä	wiki
permalosità	permälozit̪ä	wiki
pernacchia	per̺n̺akk̟ja	wiki
pernicie	per̺n̺iːt͡ʃe	wiki
perniciosamente	per̺n̺it͡ʃoz̪äme̞n̪t̪e	wiki
perniciosità	per̺n̺it͡ʃoz̪it̪ä	wiki
pernicioso	per̺n̺it͡ʃoːz̪o	wiki
perpignano	perpiɲːäːno	wiki
persa	pɛr̺s̪ä	wiki
perseguire	per̺s̪eɡwiːr̺e	wiki
persesco	per̺s̪es̪ko	wiki
pesante	pesante	wiki
pesto	pes̪t̪o	wiki
peto	peːt̪o	wiki
petonciano	pet̪on̠ʲt͡ʃäːno	wiki
petragnola	pet̪r̺äɲɲɔːl̺ä	wiki
petraiola	pet̪r̺äjɔːl̺ä	wiki
pettobianco	pɛt̪t̪objäŋko̞	wiki
pezza	pɛtt͡sä	wiki
pezzente	pet̪t̪͡s̪ɛn̪t̪e	wiki
phobos	fɔːbos̪	wiki
piazza	pjät̪t̪͡s̪ä	wiki
piazzetta	pjät̪t̪͡s̪e̞t̪t̪ä	wiki
picciotto	pitt͡ʃɔt̪t̪o	wiki
piccola	pikːol̺ä	wiki
pico	piːko	wiki
pieno	pjɛno	wiki
piercing	pir̺s̪iŋɡ	wiki
pieta	pjɛːt̪ä	wiki
pietade	pjet̪äːd̪e̞	wiki
pietate	pjet̪äːt̪e̞	wiki
pietra	pjɛtra	wiki
pietà	pjet̪ä	wiki
pieve	pjɛːve	wiki
pigiadiraspare	pid͡ʒäd̪ir̺äs̪päːr̺e	wiki
pigiadiraspatrice	pid͡ʒäd̪ir̺äs̪pät̪r̺iːt͡ʃe	wiki
pigiama	pid͡ʒäːmä	wiki
pigiare	pid͡ʒäːr̺e̞	wiki
pigiata	pid͡ʒäːt̪ä	wiki
pigrezza	piɡr̺et̪t̪͡s̪ä	wiki
pillacchera	pil̺l̺äkke̞r̺ä	wiki
pinguino	piŋɡwiːn̺o	wiki
pinocchiata	pinok̟ːjäːt̪ä	wiki
pinocchio	pinɔk̟ːjo	wiki
pinzillacchera	pin̪t̪͡s̪il̺l̺äkke̞r̺ä	wiki
pinzimonio	pin̪t̪͡s̪imɔːn̺jo	wiki
pioppaia	pjoppäːjä	wiki
pioppeto	pjoppeːt̪o	wiki
pipistrello	pipis̪t̪r̺ɛl̺l̺o	wiki
pirazina	pir̺äd̪͡z̪iːn̺ä	wiki
pirico	piːr̺iko	wiki
piropo	pir̺ɔːpo	wiki
pischella	pis̪kɛl̺l̺ä	wiki
pischelletta	pis̪kel̺l̺et̪t̪ä	wiki
pischelletto	pis̪kel̺l̺et̪t̪o	wiki
pischello	pis̪kɛl̺l̺o	wiki
pisello	piz̪ɛl̺l̺o	wiki
pispigliare	pis̪piʎʎäːr̺e̞	wiki
pispilloria	pis̪pillɔːr̺jä	wiki
pistola	pis̪t̪ol̺ä	wiki
pistola	pis̪t̪ɔːl̺ä	wiki
pistolettata	pis̪t̪ol̺et̪t̪äːt̪ä	wiki
pistoliere	pis̪t̪ol̺jɛːr̺e	wiki
pistore	pis̪t̪oːr̺e	wiki
pistrino	pis̪t̪r̺iːn̺o	wiki
pito	piːt̪o	wiki
piuma	pjuma	wiki
pizia	pit̪͡ːs̪jä	wiki
pizio	pit̪͡ːs̪jo	wiki
pizzicagnola	pit̪t̪͡s̪ikä̯ɲːo̞l̺ä̯	wiki
pizzicagnolo	pit̪t̪͡s̪ikä̯ɲːo̞l̺o	wiki
pizzicarolo	pit̪t̪͡s̪ikä̯r̺ɔːl̺o	wiki
pizzicheria	pit̪t̪͡s̪iker̺iä̯	wiki
piùe	pjue̯	wiki
piùe	pjuːe	wiki
planare	pl̺än̪äːr̺e̞	wiki
plasmorragia	pl̺äz̪mo̞r̺r̺äd͡ʒiːä	wiki
plasmorrea	pl̺äz̪mo̞r̺r̺ɛːä	wiki
plastica	plas̪t̪͡ika	wiki
platina	pl̺äːt̪in̺ä	wiki
platino	pl̺äːt̪in̺o	wiki
plausibile	pl̺äu̯z̪iːbil̺e	wiki
plebaglia	pl̺ebäʎːä	wiki
plebe	pl̺ɛːbe	wiki
pleonasmo	pl̺eon̺äzmo	wiki
pleonasmo	pl̺e̯on̺äzmo	wiki
plico	pl̺iːko	wiki
pliocene	pl̺iot͡ʃɛːn̺e	wiki
pliocenico	pliot͡ʃɛːn̺iko	wiki
plumcake	pluŋ̟k̟ei̯k	wiki
plumcake	pluŋ̟k̟ɛi̯k	wiki
plurivoco	pl̺ur̺iːvoko	wiki
poco	pɔːko	wiki
poculo	pɔːkul̺o	wiki
poffare	poffäːr̺e̞	wiki
poggio	pɔddʒo	wiki
poliglottia	pol̺iɡl̺ot̪t̪iːä	wiki
poliglottismo	pol̺iɡl̺ot̪t̪iz̪mo	wiki
polio	pɔːl̺jo	wiki
poliste	pol̺is̪t̪e	wiki
pollaio	pol̺l̺äːjo	wiki
pollaiola	pol̺l̺äjɔːl̺ä	wiki
pollaiolo	pol̺l̺äjɔːl̺o	wiki
pollaiuolo	pol̺l̺äjwɔːl̺o	wiki
pollastra	pol̺l̺äs̪t̪r̺ä	wiki
pollastro	pol̺l̺äs̪t̪r̺o	wiki
pollicino	polːit͡ʃiːno	wiki
pollina	pol̺l̺iːn̺ä	wiki
polta	pol̪t̪ä	wiki
poltro	poltro	wiki
polve	pol̺ve	wiki
polvere	pol̺ver̺e	wiki
pomata	pomäːt̪ä	wiki
pomeriggio	pomeriddʒo	wiki
pomodoro	pomod̪ɔːro	wiki
pompino	pompiːn̺o	wiki
ponce	pɔn̺ʲt͡ʃe	wiki
ponente	pon̺ɛn̪t̪e	wiki
pongo	poŋɡo	wiki
pongo	pɔŋɡo	wiki
ponti	pon̪t̪i	wiki
ponti	pɔn̪t̪i	wiki
ponticello	pon̪t̪it͡ʃɛl̺l̺o	wiki
ponto	pɔn̪t̪o	wiki
popolano	popol̺äːn̺o̞	wiki
popolano	pɔːpol̺än̺o̞	wiki
porca	pɔr̺kä	wiki
porcareccia	por̺kär̺e̞tt͡ʃä	wiki
porchereccia	por̺ker̺e̞tt͡ʃä	wiki
porchereccio	por̺ker̺ett͡ʃo	wiki
porcile	por̺t͡ʃiːl̺e	wiki
porco	pɔr̺ko	wiki
porfiroblastico	por̺fir̺obl̺äs̪t̪iko	wiki
porfiroclastico	por̺fir̺okl̺äs̪t̪iko	wiki
porno	pɔr̺n̺o	wiki
pornografia	por̺n̺oɡr̺äfiːä	wiki
pornografico	pornoɡraːfiko	wiki
pornografico	pɔrno̞ɡraːfiko	wiki
porraccio	por̺r̺ätt͡ʃo̞	wiki
porrandello	por̺r̺än̪d̪ɛl̺l̺o	wiki
porrazzo	por̺r̺ät̪t̪͡s̪o̞	wiki
porro	pɔr̺r̺o	wiki
portabombe	pɔr̺t̪äbo̞mbe	wiki
portiere	por̺t̪jɛːr̺e	wiki
porto	pɔr̺t̪o	wiki
portoferraio	pɔr̪t̪oferːäːjo	wiki
portogallo	port̪oɡälːo	wiki
portolano	por̺t̪ol̺äːn̺o̞	wiki
portuale	por̺t̪uäːl̺e̞	wiki
portuale	por̺t̪wäːl̺e̞	wiki
poscia	pɔʃʃä	wiki
poscrai	poskr̺äi̯	wiki
posdiluviano	pɔz̪d̪il̺uvjäːn̺o̞	wiki
posdomani	pɔz̪d̪omäːn̺i	wiki
positio	poz̪it̪t̪͡s̪jo	wiki
possa	pɔs̪s̪ä	wiki
postalveolare	pɔst̪äl̺veol̺äːr̺e	wiki
postalveolare	pɔst̪äl̺ve̯ol̺äːr̺e	wiki
postdiluviale	pɔz̪d̪il̺uvjäːl̺e̞	wiki
postdiluviano	pɔz̪d̪il̺uvjäːn̺o̞	wiki
postribolo	pos̪t̪r̺iːbol̺o	wiki
potabile	pot̪äːbil̺e	wiki
potare	pot̪äːr̺e̞	wiki
potassio	pot̪äsːjo	wiki
potere	pot̪eːr̺e	wiki
poti	poːt̪i	wiki
poti	pɔːt̪i	wiki
potissimamente	pot̪is̪s̪imäme̞n̪t̪e	wiki
potissimo	pot̪is̪s̪imo	wiki
poto	poːt̪o	wiki
poto	pɔːt̪o	wiki
potorio	pot̪ɔːr̺jo	wiki
pozione	pot̪t̪͡s̪joːn̺e	wiki
practico	pr̺äkt̪iko	wiki
prana	pr̺äːn̺ä	wiki
prandiale	pr̺än̪d̪jäːl̺e̞	wiki
prandio	pr̺än̪d̪jo	wiki
pranso	pr̺än̪s̪o̞	wiki
pratica	pr̺äːt̪ikä	wiki
pratico	pr̺äːt̪iko	wiki
prattico	pr̺ät̪t̪iko	wiki
pravamente	pr̺äväme̞n̪t̪e	wiki
pravità	pr̺ävit̪ä	wiki
pravo	pr̺äːvo̞	wiki
precambriano	pr̺ekämbr̺jäːn̺o̞	wiki
precipitare	pr̺et͡ʃipit̪aːr̺e	wiki
precipitevole	pr̺et͡ʃipit̪eːvol̺e	wiki
precipitevolissimevolmente	pr̺et͡ʃipit̪evol̺is̪ːimevol̺men̪t̪e	wiki
precipitevolissimo	pr̺etʃipit̪evol̺is̪s̪imo	wiki
precipitevolmente	pr̺et͡ʃipit̪evol̺men̪t̪e	wiki
precone	pr̺ekoːn̺e	wiki
preconio	pr̺ekɔːn̺jo	wiki
preconizzare	pr̺ekon̺id̪d̪͡z̪äːr̺e̞	wiki
prefazio	pr̺efät̪t̪͡s̪jo	wiki
prefettizio	pr̺efet̪ːit̪͡ːs̪jo	wiki
prefica	pr̺ɛːfikä	wiki
pregio	pr̺ɛːd͡ʒo	wiki
pregiudicare	pr̺ed͡ʒud̪ikaːr̺e̞	wiki
prelatizio	pr̺el̺ät̪it̪͡ːs̪jo	wiki
prelato	pr̺el̺äːt̪o̞	wiki
premianda	pr̺emjän̪d̪ä	wiki
premiando	pr̺emjän̪d̪o̞	wiki
premonastico	pr̺emon̺äs̪t̪iko	wiki
premonitore	pr̺emon̺it̪oːr̺e	wiki
premonitorio	pr̺emon̺it̪ɔːr̺jo	wiki
premonizione	pr̺emon̺it̪t̪͡s̪joːn̺e	wiki
prenascere	pr̺en̺äʃʃe̞r̺e	wiki
prenato	pr̺en̺äːt̪o̞	wiki
prenotazione	pr̺en̺ot̪ät̪t̪͡s̪joːn̺e	wiki
preposito	pr̺epɔːz̪it̪o	wiki
preposizione	pr̺epoz̪it̪͡s̪joːn̺e	wiki
prepotente	pr̺epot̪ɛn̪t̪e	wiki
prescia	prɛʃːä	wiki
presentare	pr̺ez̪en̪t̪äːr̺e̞	wiki
presentimento	pr̺es̪en̪t̪imen̪t̪o	wiki
presentire	pr̺es̪en̪t̪iːr̺e	wiki
presento	pr̺es̪ɛn̪t̪o	wiki
presento	pr̺ez̪ɛn̪t̪o	wiki
presso	pr̺ɛs̪s̪o	wiki
prestezza	pr̺es̪t̪et̪t̪͡s̪ä	wiki
prestinaia	prest̪inäːjä	wiki
prestinaio	prest̪inäːjo	wiki
presto	pr̺ɛs̪t̪o	wiki
pretenzione	pr̺et̪en̪t̪͡s̪joːn̺e	wiki
preterintenzionale	pr̺et̪er̺in̪t̪en̪t̪͡s̪jon̺äːl̺e̞	wiki
pretestare	pr̺et̪es̪t̪äːr̺e̞	wiki
pretestazione	pr̺et̪es̪t̪ät̪t̪͡s̪joːn̺e	wiki
pretesto	pr̺et̪ɛs̪t̪o	wiki
prevelare	pr̺evel̺äːr̺e̞	wiki
prevosto	pr̺evɔs̪t̪o	wiki
pria	pr̺iːä	wiki
prigione	pr̺id͡ʒoːn̺e	wiki
primaio	pr̺imäːjo̞	wiki
primario	pr̺imäːr̺jo	wiki
primavera	pr̺imävɛːr̺ä	wiki
primigenio	pr̺imid͡ʒɛːn̺jo	wiki
primo	pr̺iːmo	wiki
principe	pr̺in̺ʲt͡ʃipe	wiki
priscione	pr̺iʃʃoːn̺e	wiki
prisco	pr̺is̪ko	wiki
prismoide	pr̺iz̪mɔi̯d̪e	wiki
pro	pr̺o	wiki
pro	pr̺ɔ	wiki
pro'	pr̺ɔ	wiki
probandato	pr̺obän̪d̪äːt̪o̞	wiki
probando	pr̺obän̪d̪o̞	wiki
probitade	pr̺obit̪äːd̪e̞	wiki
probitate	pr̺obit̪äːt̪e̞	wiki
probità	pr̺obit̪ä	wiki
procace	pr̺okaːt͡ʃe	wiki
procacemente	pr̺okat͡ʃemen̪t̪e	wiki
procacia	pr̺okaːt͡ʃa	wiki
procacità	pr̺okat͡ʃit̪a	wiki
procambio	pr̺okämbjo	wiki
processuale	pr̺ot͡ʃes̪s̪uäːl̺e̞	wiki
processuale	pr̺ot͡ʃes̪s̪wäːl̺e̞	wiki
prode	pr̺ɔːd̪e	wiki
profittatore	pr̺ofit̪t̪ät̪o̞ːr̺e	wiki
profittatrice	pr̺ofit̪t̪ät̪r̺iːt͡ʃe	wiki
proloquio	pr̺ol̺ɔːkwjo	wiki
promemoria	pr̺omemɔːr̺jä	wiki
prono	prɔːno̞	wiki
pronome	pr̺on̺oːme	wiki
pronto	pron̪t̪o	wiki
pronuncia	pr̺on̺un̺ʲt͡ʃä	wiki
propugnacolo	pr̺opuɲɲäːko̞l̺o	wiki
prora	pr̺ɔːr̺ä	wiki
prosapia	pr̺oz̪äːpjä	wiki
proscenio	pr̺oʃʃɛːn̺jo	wiki
prosciutto	pr̺oʃʃutt̪o	wiki
proseguire	pr̺oz̪eɡwiːr̺e	wiki
prosieguo	pr̺os̪jɛːɡwo	wiki
protagonista	pr̺ot̪äɡo̞n̺is̪t̪ä	wiki
proto	pr̺ɔːt̪o	wiki
protoclasi	pr̺ɔt̪okl̺äːz̪i	wiki
protoclastico	pr̺ɔt̪okl̺äs̪t̪iko	wiki
protocuneiforme	pr̺ɔt̪okun̺ei̯for̺me	wiki
prova	pr̺ɔːvä	wiki
proverbio	pr̺ovɛr̺bjo	wiki
provocare	pr̺ovokäːr̺e̞	wiki
provocatore	pr̺ovokät̪o̞ːr̺e	wiki
provocatori	pr̺ovokät̪o̞ːr̺i	wiki
provocatori	pr̺ovokät̪ɔːr̺i	wiki
provocatorio	pr̺ovokät̪ɔːr̺jo	wiki
provocazione	pr̺ovokät̪͡s̪joːn̺e	wiki
prulaurasina	pr̺ul̺au̯r̺äz̪iːn̺ä	wiki
pruova	pr̺wɔːvä	wiki
pseudocupola	ps̪ɛu̯d̪okuːpol̺ä	wiki
pseudopecora	ps̪ɛu̯d̪opɛːkor̺ä	wiki
pseudopecore	ps̪ɛu̯d̪opɛːkor̺e	wiki
psiche	ps̪iːk̟e	wiki
psichedelia	ps̪ik̟ed̪el̺iːä	wiki
psichedelico	ps̪ik̟ed̪ɛːl̺iko	wiki
psicologo	pissikɔloɡo	wiki
psicologo	sikɔloɡo	wiki
psicopompo	ps̪ikopompo	wiki
puddinga	pud̪d̪iŋɡä	wiki
puerizia	pwer̺it̪t̪͡s̪jä	wiki
puerperio	pwer̺pɛːr̺jo	wiki
puffo	puffo	wiki
pugio	puːd͡ʒo	wiki
pugione	pud͡ʒoːn̺e	wiki
pugna	puɲːa	wiki
pugnace	puɲɲaːt͡ʃe	wiki
pugnalare	puɲɲalare	wiki
pugno	puɲɲo	wiki
pulcella	pul̺ʲt͡ʃɛl̺l̺ä	wiki
pulcino	pul̺ʲt͡ʃiːn̺o	wiki
pulcro	pul̺kr̺o	wiki
pulzella	pul̺t̪͡s̪ɛl̺l̺ä	wiki
pummarola	pumːär̺ɔːl̺ä	wiki
pungere	pun̺ʲd͡ʒer̺e	wiki
puntigliarsi	pun̪t̪iʎʎär̺s̪i	wiki
puntiglio	pun̪t̪iʎʎo	wiki
pupazzo	pupät̪t̪͡s̪o̞	wiki
pupo	puːpo	wiki
pusta	pus̪t̪ä	wiki
putrella	putrɛlla	wiki
putresceina	put̪r̺eʃʃeiːn̺ä	wiki
putrescente	put̪r̺eʃʃɛn̪t̪e	wiki
putrescina	put̪r̺eʃʃiːn̺ä	wiki
puttana	put̪t̪äːn̺ä	wiki
qafiz	käfiz̪	wiki
quaderno	kwäd̪ɛr̺n̺o	wiki
quadrato	kwad̪r̺aːt̪o	wiki
quadrigato	kwad̪riɡaːt̪o	wiki
quadrisdrucciolo	kwäd̪r̺iz̪d̪r̺utt͡ʃol̺o	wiki
quadrittongo	kwäd̪r̺it̪t̪ɔŋɡo	wiki
qualche	kwäl̺ke̞	wiki
quale	kwäːl̺e	wiki
qualunque	kwäl̺uŋkwe	wiki
quando	kwando	wiki
quandunque	kwän̪d̪uŋkwe	wiki
quantificare	kwän̪t̪ifikäːr̺e̞	wiki
quantunque	kwän̪t̪uŋkwe	wiki
quarkonio	kwär̺kɔːn̺jo	wiki
quartabuono	kwär̺t̪äbwɔːn̺o	wiki
quartarolo	kwär̺t̪är̺ɔːl̺o	wiki
quasi	kwaːzi	wiki
quattordici	kwat̪t̪ord̪it͡ʃi	wiki
quattro	kwät̪t̪r̺o̞	wiki
quattrocchi	kwät̪t̪r̺ɔkk̟i	wiki
quebracho	kebr̺äːt͡ʃo̞	wiki
quebraco	kebr̺äːko̞	wiki
quegli	kweʎʎi	wiki
quelli	kwel̺l̺i	wiki
quello	kwello	wiki
querceto	kwert͡ʃeːt̪o	wiki
quercia	kwɛr̺t͡ʃä	wiki
questione	kwes̪t̪joːn̺e	wiki
questo	kʷes̪t̪o	wiki
quetanza	kwet̪än̪t̪͡s̪ä	wiki
quetazione	kwet̪ät̪t̪͡s̪joːn̺e	wiki
qui	kwi	wiki
quiescente	kwjeʃʃɛn̪t̪e	wiki
quiescenza	kwjeʃʃɛn̪t̪͡s̪ä	wiki
quietamento	kwjet̪äme̞n̪t̪o	wiki
quietanza	kwjet̪än̪t̪͡s̪ä	wiki
quietanzare	kwjet̪än̪t̪͡s̪äːr̺e̞	wiki
quietanzatore	kwjet̪än̪t̪͡s̪ät̪oːr̺e	wiki
quietanzatrice	kwjet̪än̪t̪͡s̪ät̪r̺iːt͡ʃe	wiki
quietare	kwjet̪äːr̺e̞	wiki
quietazione	kwjet̪ät̪t̪͡s̪joːn̺e	wiki
quiete	kwjɛːt̪e	wiki
quietezza	kwjet̪et̪t̪͡s̪ä	wiki
quietismo	kwjet̪iz̪mo	wiki
quietista	kwjet̪is̪t̪ä	wiki
quietistico	kwjet̪is̪t̪iko	wiki
quietitudine	kwjet̪it̪uːd̪in̺e	wiki
quieto	kwjɛːt̪o	wiki
quietudine	kwjet̪uːd̪in̺e	wiki
quincentro	kwin̺ʲt͡ʃen̪t̪r̺o	wiki
quindeci	kwin̪d̪et͡ʃi	wiki
quindi	kwin̪d̪i	wiki
quindici	kwin̪d̪it͡ʃi	wiki
quinquenne	kwiŋkwɛn̺n̺e	wiki
quinta	kwint̪a	wiki
quinterno	kwin̪t̪ɛr̺n̺o	wiki
quinto	kwint̪o	wiki
quirina	kwir̺iːn̺ä	wiki
quirinale	kwir̺in̺äːl̺e̞	wiki
quirinali	kwir̺in̺äːl̺i	wiki
quirinalie	kwir̺in̺äːl̺je	wiki
quirinalista	kwir̺in̺äl̺is̪t̪ä	wiki
quirinalizio	kwir̺in̺äl̺it̪͡ːs̪jo	wiki
quirino	kwir̺iːn̺o	wiki
quistione	kwis̪t̪joːn̺e	wiki
quitanza	kwit̪än̪t̪͡s̪ä	wiki
quitazione	kwit̪ät̪t̪͡s̪joːn̺e	wiki
quittanza	kwit̪t̪än̪t̪͡s̪ä	wiki
quivi	kwiːvi	wiki
quorum	kwɔːr̺um	wiki
raba	r̺äːbä	wiki
rabaton	r̺äbät̪on̺	wiki
rabaton	r̺äbät̪ɔn̺	wiki
rabbi	r̺äbːi	wiki
rabbia	r̺äbbjä	wiki
rabdomioblastico	r̺äbd̪o̞mjobl̺äs̪t̪iko	wiki
rabdomioblasto	r̺äbd̪o̞mjobl̺äs̪t̪o̞	wiki
raccennare	r̺ätt͡ʃen̺n̺äːr̺e̞	wiki
racchio	r̺äkk̟jo	wiki
raccolta	r̺äkkɔl̪t̪ä	wiki
radiante	r̺äd̪jän̪t̪e̞	wiki
radica	r̺äːd̪ikä	wiki
radicchio	r̺äd̪ikkjo	wiki
radice	raditʃe	wiki
radioassistere	r̺äd̪joäs̪s̪is̪t̪er̺e	wiki
radiocobalto	r̺äd̪jokobäl̪t̪o̞	wiki
radiotelegrafia	r̺äd̪jot̪el̺eɡr̺äfiːä	wiki
radon	räːd̪on	wiki
radon	räːd̪ɔn	wiki
raffica	r̺äffikä	wiki
raffreddore	r̺äffr̺e̞d̪d̪oːr̺e	wiki
raga	r̺äːɡä	wiki
ragazza	räɡät̪͡ːs̪ä	wiki
ragione	r̺äd͡ʒo̞ːn̺e	wiki
ragno	r̺äɲɲo̞	wiki
ragoideo	r̺äɡo̞i̯d̪ɛːo	wiki
ragutiera	r̺äɡut̪jɛːr̺ä	wiki
ragù	r̺äɡu	wiki
rai	r̺äi̯	wiki
raimondo	r̺äi̯mon̪d̪o	wiki
rais	r̺äis̪	wiki
rame	r̺äːme̞	wiki
ramino	rämiːno	wiki
ramino	räːmino	wiki
ramoscello	r̺ämo̞ʃʃɛl̺l̺o	wiki
rampollo	r̺ämpo̞l̺ːo	wiki
rancidume	r̺än̺ʲt͡ʃid̪uːme	wiki
rancore	r̺äŋko̞ːr̺e	wiki
rancorosamente	r̺äŋko̞r̺oz̪äme̞n̪t̪e	wiki
rancoroso	r̺äŋko̞r̺oːz̪o	wiki
rannodare	r̺än̺n̺o̞d̪äːr̺e̞	wiki
rapa	raːpa	wiki
rapallizzazione	r̺apal̺l̺id̪d̪͡z̪at̪͡s̪joːn̺e	wiki
rape	raːpe	wiki
rapsodia	r̺äps̪o̞d̪iːä	wiki
rapsodico	r̺äps̪ɔːd̪iko	wiki
rapsodo	r̺äps̪ɔːd̪o	wiki
rara	raːra	wiki
ras	r̺äs̪	wiki
rassegnatamente	r̺äs̪s̪e̞ɲɲät̪äme̞n̪t̪e	wiki
rassegnato	r̺äs̪s̪e̞ɲɲäːt̪o̞	wiki
rateo	r̺äːt̪e̞o	wiki
ratio	r̺ät̪t̪͡s̪jo	wiki
ratto	r̺ät̪t̪o̞	wiki
ravanello	rävänɛlːo	wiki
razza	räd̪d̪͡z̪ä	wiki
razza	rät̪t̪͡s̪ä	wiki
re	r̺e	wiki
re	r̺ɛ	wiki
realizzarsi	r̺eä̯l̺id̪d̪͡z̪är̺s̪i	wiki
realizzazione	realiddzattsjone	wiki
reatino	r̺e̯ät̪iːn̺o	wiki
recede	ret͡ʃɛːd̪e	wiki
recedere	ret͡ʃɛːdere	wiki
recedé	ret͡ʃed̪e	wiki
reddita	r̺ed̪d̪iːt̪ä	wiki
redita	r̺ed̪iːt̪ä	wiki
redituro	r̺ed̪it̪uːr̺o	wiki
refettorio	r̺efet̪t̪ɔːr̺jo	wiki
refulgere	r̺eful̺ʲd͡ʒer̺e	wiki
refutare	r̺efut̪äːr̺e̞	wiki
rege	r̺ɛːd͡ʒe	wiki
reggere	r̺ɛdd͡ʒer̺e	wiki
regno	r̺eɲɲo	wiki
regola	r̺ɛːɡol̺ä	wiki
regolare	r̺eɡol̺äːr̺e	wiki
religionaria	r̺el̺id͡ʒon̺äːr̺jä	wiki
religionario	r̺el̺id͡ʒon̺äːr̺jo̞	wiki
religione	r̺el̺id͡ʒoːn̺e	wiki
relitto	r̺el̺it̪t̪o	wiki
remote	remɔːt̪e	wiki
remoto	remɔːt̪o	wiki
renella	r̺en̺ɛl̺l̺ä	wiki
renello	r̺en̺ɛl̺l̺o	wiki
renzi	r̺ɛn̪t̪͡s̪i	wiki
renziano	r̺en̪t̪͡s̪jäːn̺o	wiki
repertorio	r̺eper̺t̪ɔːr̺jo	wiki
repubblica	r̺epubːl̺ikä	wiki
republica	r̺epuːbl̺ikä	wiki
requiare	r̺ekwjäːr̺e̞	wiki
requie	r̺ɛːkwje	wiki
requiem	r̺ɛːkwjem	wiki
ressa	rɛssa	wiki
restaurare	r̺es̪t̪äu̯r̺äːr̺e̞	wiki
resurgere	r̺es̪ur̺d͡ʒer̺e	wiki
rete	reːt̪e	wiki
retentire	r̺et̪en̪t̪iːr̺e	wiki
retinasfalto	r̺et̪in̺äs̪fäl̪t̪o̞	wiki
retroflesso	r̺et̪r̺ofl̺ɛs̪s̪o	wiki
retrogusto	r̺et̪r̺oɡus̪t̪o	wiki
retrorazzo	r̺ɛt̪r̺or̺äd̪d̪͡z̪o̞	wiki
retta	r̺ɛt̪t̪ä	wiki
rettamente	r̺et̪t̪ämen̪t̪e	wiki
rettangolare	r̺et̪t̪äŋɡol̺äːr̺e	wiki
rettangolo	r̺et̪t̪äŋɡo̞l̺o	wiki
rettitudine	r̺et̪t̪it̪uːd̪in̺e	wiki
retto	r̺ɛt̪t̪o	wiki
rettore	r̺et̪t̪oːr̺e	wiki
rettovescicale	r̺et̪t̪oveʃʃikäːl̺e	wiki
rettovescicale	r̺ɛt̪t̪oveʃʃikäːl̺e	wiki
reuma	r̺ɛu̯mä	wiki
revoca	r̺ɛːvokä	wiki
revocare	r̺evokäːr̺e̞	wiki
rho	r̺ɔ	wiki
riaccennare	r̺jätt͡ʃen̺n̺äːr̺e̞	wiki
riaggiustamento	r̺jädd͡ʒus̪t̪äme̞n̪t̪o	wiki
riaggiustare	r̺jädd͡ʒus̪t̪äːr̺e̞	wiki
riaggiustarsi	r̺jadd͡ʒus̪t̪är̺s̪i	wiki
riagguantare	r̺iäɡɡwän̪t̪äːr̺e̞	wiki
riagguantare	r̺jäɡɡwän̪t̪äːr̺e̞	wiki
ribollita	ribolːiːt̪ä	wiki
ricci	rittʃi	wiki
ricerca	ritʃerka	wiki
richiedere	r̺ikjɛːd̪er̺e	wiki
riddenna	r̺id̪d̪ɛn̺n̺ä	wiki
ridenna	r̺id̪ɛn̺n̺ä	wiki
ridere	r̺iːd̪er̺e	wiki
rifiutare	r̺ifjut̪äːr̺e̞	wiki
rifuggire	r̺ifudd͡ʒiːr̺e	wiki
rifulgente	r̺iful̺ʲd͡ʒɛn̪t̪e	wiki
rifulgere	r̺iful̺ʲd͡ʒer̺e	wiki
rimeditare	r̺imed̪it̪äːr̺e̞	wiki
rimpatrianda	r̺impät̪r̺jän̪d̪ä	wiki
rimpatriando	r̺impät̪r̺jän̪d̪o̞	wiki
rimpennare	r̺impen̺n̺äːr̺e̞	wiki
rimpennarsi	r̺impen̺n̺är̺s̪i	wiki
rinascimento	r̺in̺äʃʃimen̪t̪o	wiki
rincoglionire	r̺iŋkoʎːon̺iːr̺e	wiki
rincoglionito	r̺iŋkoʎːon̺iːt̪o	wiki
rinnegatore	r̺in̺n̺eɡät̪o̞ːr̺e	wiki
rinnegatrice	r̺in̺n̺eɡät̪r̺iːt͡ʃe	wiki
rinnovare	r̺in̺ːoväːr̺e̞	wiki
rione	rione	wiki
risanguare	r̺is̪äŋɡwäːr̺e̞	wiki
risata	r̺iz̪äːt̪ä	wiki
rischio	r̺is̪kjo	wiki
risco	r̺is̪ko	wiki
riscritto	r̺is̪kr̺it̪t̪o	wiki
riscrittura	r̺is̪kr̺it̪t̪uːr̺ä	wiki
riscrivere	r̺is̪kr̺iːver̺e	wiki
risorgere	r̺is̪or̺d͡ʒer̺e	wiki
risvegliare	riz̪veʎʎäːr̺e̞	wiki
risvoltare	r̺iz̪vol̪t̪äːr̺e̞	wiki
ritidoma	r̺it̪id̪ɔːmä	wiki
ritraggere	r̺it̪r̺ädd͡ʒe̞r̺e	wiki
riviera	r̺ivjɛːr̺ä	wiki
rivolvere	r̺ivɔl̺ver̺e	wiki
rizatono	r̺id̪͡z̪äːt̪o̞n̺o	wiki
rizoatono	r̺id̪͡z̪oäːt̪o̞n̺o	wiki
rizotonico	r̺id̪͡z̪ot̪ɔːn̺iko	wiki
roba	r̺ɔːbä	wiki
roberto	r̺obɛr̺t̪o	wiki
roborante	r̺obor̺än̪t̪e̞	wiki
roborare	r̺obor̺äːr̺e̞	wiki
robusto	r̺obus̪t̪o	wiki
robustoso	r̺obus̪t̪oːz̪o	wiki
roccia	r̺ɔtt͡ʃä	wiki
rodolfo	rodɔlfo	wiki
rodrigo	rodriːɡo	wiki
roentgenio	reŋɡ̟ɛːnjo	wiki
roero	roɛːro	wiki
roggero	r̺odd͡ʒɛːr̺o	wiki
roma	r̺oːma	wiki
romanesco	r̺omän̺e̞s̪ko	wiki
romano	r̺omaːn̺o	wiki
romeno	romɛːno	wiki
ronca	r̺oŋkä	wiki
roncare	r̺oŋkäːr̺e̞	wiki
roncola	r̺oŋkol̺ä	wiki
roncolare	r̺oŋkol̺äːr̺e̞	wiki
roncolata	r̺oŋkol̺äːt̪ä	wiki
roncolatura	r̺oŋkol̺ät̪uːr̺ä	wiki
roncolo	r̺oŋkol̺o	wiki
rosignolo	r̺oz̪iɲɲɔːl̺o	wiki
rosignuolo	r̺oz̪iɲɲwɔːl̺o	wiki
rosmarino	roz̪mär̺iːn̺o	wiki
rosolia	r̺oz̪ol̺iːä	wiki
rota	r̺ɔːt̪ä	wiki
rotacismo	r̺ot̪at͡ʃiz̪mo	wiki
rotacismo	r̺ɔt̪at͡ʃiz̪mo	wiki
rotondo	rotondo	wiki
rovere	r̺oːver̺e	wiki
rovina	r̺oviːn̺ä	wiki
rozzezza	r̺od̪̪d͡z̪et̪t̪͡s̪ä	wiki
rozzo	r̺od̪d̪͡z̪o	wiki
rozzore	r̺od̪d̪͡z̪oːr̺e	wiki
rozzume	r̺od̪d̪͡z̪uːme	wiki
rubacchiare	r̺ubäkk̟jäːr̺e̞	wiki
rubato	rubaːto	wiki
rubbiolo	r̺ubbjɔːl̺o	wiki
rubino	r̺ubiːn̺o	wiki
rubino	r̺uːbin̺o	wiki
rubro	r̺uːbr̺o	wiki
ruca	r̺uːkä	wiki
ruchetta	r̺uk̟et̪t̪a	wiki
rufo	r̺uːfo	wiki
ruggeri	r̺udd͡ʒɛːr̺i	wiki
ruggero	r̺udd͡ʒɛːr̺o	wiki
ruggiero	r̺udd͡ʒɛːr̺o	wiki
ruina	r̺uiːn̺a	wiki
rumeno	rumɛːno	wiki
ruota	r̺wɔːt̪ä	wiki
rusignolo	r̺uz̪iɲɲɔːl̺o	wiki
rusignuolo	r̺uz̪iɲɲwɔːl̺o	wiki
russia	r̺us̪s̪jä	wiki
rustico	r̺us̪t̪iko	wiki
rutto	r̺ut̪t̪o	wiki
ruzzare	r̺ud̪d̪͡z̪äːr̺e̞	wiki
ruzzo	r̺ud̪d̪͡z̪o	wiki
saba	s̪äːbä	wiki
sabato	säːbät̪o	wiki
sabbia	s̪äbːjä	wiki
sabbietta	s̪äbbjet̪t̪ä	wiki
sabra	s̪äːbr̺ä	wiki
sabre	s̪äːbr̺e̞	wiki
saccobronco	s̪äkko̞br̺oŋko	wiki
sacrilegio	s̪äkr̺il̺ɛːd͡ʒo	wiki
sacrilego	s̪äkr̺iːl̺eɡo	wiki
sacro	s̪äːkr̺o̞	wiki
saetta	s̪äe̞t̪t̪ä	wiki
saga	s̪äːɡä	wiki
sago	s̪äːɡo̞	wiki
sagola	s̪äːɡo̞l̺ä	wiki
sahara	s̪ääːr̺ä	wiki
sahariano	s̪äːr̺jäːn̺o̞	wiki
salame	s̪äl̺äːme̞	wiki
salceto	s̪äl̺ʲt͡ʃe̞ːt̪o	wiki
salice	s̪äːl̺it͡ʃe	wiki
saliceto	s̪äl̺it͡ʃeːt̪o	wiki
saliva	s̪äl̺iːvä	wiki
salmonare	s̪äl̺mo̞n̺äːr̺e̞	wiki
salmonatura	s̪äl̺mo̞n̺ät̪ur̺ä	wiki
salmone	s̪äl̺mo̞ːn̺e	wiki
salmonide	s̪äl̺mɔːn̺id̪e	wiki
salmonidi	s̪äl̺mɔːn̺id̪i	wiki
saltimbanca	s̪äl̺t̪imbäŋkä	wiki
saltimbanco	s̪äl̺t̪imbäŋko̞	wiki
salume	s̪äl̺uːme	wiki
salvacondotto	s̪äl̺väko̞n̪d̪ot̪t̪o	wiki
salvaggio	s̪äl̺vädd͡ʒo̞	wiki
sambuca	sämbuːkä	wiki
sambuco	sämbuːko	wiki
samurai	s̪ämur̺äi̯	wiki
samurai	s̪ämur̺äːi	wiki
sancire	s̪än̺ʲt͡ʃiːr̺e	wiki
sanculottide	säŋkulɔt̪ːid̪e̞	wiki
sangria	säŋɡriːä	wiki
sanna	s̪än̺n̺ä	wiki
sannuto	s̪än̺n̺uːt̪o	wiki
sansa	s̪än̪s̪ä	wiki
sansificio	s̪än̪s̪ifiːt͡ʃo	wiki
santippe	s̪an̪t̪ippe	wiki
santoreggia	s̪än̪t̪o̞r̺edd͡ʒä	wiki
sanza	s̪än̪t̪͡s̪ä	wiki
sapere	sapeːre	wiki
sapone	s̪äpo̞ːn̺e	wiki
sarago	s̪äːr̺äɡo̞	wiki
sarcasmo	s̪är̺käz̪mo̞	wiki
sarcastico	s̪är̺käs̪t̪iko	wiki
sarchiare	s̪är̺kjäːr̺e̞	wiki
sarei	s̪ar̺ɛi̯	wiki
sargia	s̪är̺d͡ʒä	wiki
sargo	s̪är̺ɡo̞	wiki
sashimi	s̪äʃʃiːmi	wiki
sasso	s̪äs̪s̪o̞	wiki
satira	s̪äːt̪ir̺ä	wiki
satireggiare	s̪ät̪ir̺ed͡ːʒäːr̺e̞	wiki
satirico	s̪ät̪iːr̺iko	wiki
satisfare	s̪ät̪is̪fäːr̺e	wiki
satisfatto	s̪ät̪is̪fät̪ːo	wiki
saturno	sat̪urno	wiki
saussurea	s̪os̪s̪uːr̺e̯ä	wiki
savoreggia	s̪ävo̞r̺edd͡ʒä	wiki
sbadiglio	z̪bad̪iʎʎo	wiki
sbadigliò	z̪bad̪iʎʎɔ	wiki
sbafare	z̪bäfäːr̺e̞	wiki
sbaglio	z̪bäʎʎo̞	wiki
sbassatura	z̪bäs̪s̪ät̪uːr̺ä	wiki
sbiennare	s̪bien̺n̺äːr̺e̞	wiki
sbloccare	z̪bl̺okkäːr̺e	wiki
sbloccarsi	z̪bl̺okkar̺s̪i	wiki
sbobinare	z̪bobin̺äːr̺e̞	wiki
sbolgiare	z̪bol̺ʲd͡ʒäːr̺e̞	wiki
sbramare	z̪br̺ämäːr̺e̞	wiki
sbrodare	z̪br̺od̪äːr̺e̞	wiki
sbroncare	z̪br̺oŋkäːr̺e̞	wiki
scalpello	s̪käl̺pɛl̺l̺o	wiki
scammonea	s̪kämmo̞n̺ɛä̯	wiki
scamone	s̪kämo̞ːn̺e	wiki
scamonea	s̪kämo̞n̺ɛä̯	wiki
scamonio	s̪kämɔːn̺jo	wiki
scamorza	s̪kämɔr̺t̪͡s̪ä	wiki
scandalizzarsi	s̪kän̪d̪äl̺id̪d̪͡z̪är̺s̪i	wiki
scandinavia	s̪kän̪d̪in̺äːvjä	wiki
scandio	s̪kän̪d̪jo	wiki
scandire	s̪kan̪d̪iːr̺e	wiki
scansafatiche	s̪kän̪s̪äfät̪iːke	wiki
scappavia	s̪käppäviːä	wiki
scarabeo	s̪kär̺äbɛːo	wiki
scarabocchio	s̪kär̺äbɔkk̟jo	wiki
scarafaggio	s̪kär̺äfäd͡ːʒo̞	wiki
scaramazza	s̪kär̺ämät̪t̪͡s̪ä	wiki
scarda	s̪kär̺d̪ä	wiki
scardola	s̪kär̺d̪o̞l̺ä	wiki
scarpa	s̪kär̺pä	wiki
scautismo	skautizmo	wiki
scavare	skavare	wiki
scegliere	ʃeʎʎer̺e	wiki
scelerare	ʃel̺er̺äːr̺e̞	wiki
scellerare	ʃel̺l̺er̺äːr̺e̞	wiki
scelo	ʃɛːl̺o	wiki
scemo	ʃeːmo	wiki
scendere	ʃːendeɾe	wiki
scentrare	ʃen̪t̪r̺äːr̺e̞	wiki
scentrato	stʃentrato	wiki
scentrato	ʃen̪t̪r̺äːt̪o̞	wiki
scevero	ʃeːver̺o	wiki
scevrare	ʃevr̺äːr̺e̞	wiki
scevro	ʃeːvr̺o	wiki
schei	s̪k̟ɛi̯	wiki
scheletro	skɛletro	wiki
schiarire	skjariːre	wiki
schiatta	s̪kjät̪t̪ä	wiki
schiavitù	sk̟jävit̪u	wiki
schiavo	sk̟jäːvo	wiki
schidione	s̪k̟id̪joːn̺e	wiki
schidone	s̪k̟id̪oːn̺e	wiki
schifo	skʲiːfo	wiki
schiuso	s̪k̟juːz̪o	wiki
schivafatiche	s̪k̟iväfät̪iːke	wiki
schivare	s̪k̟iväːr̺e̞	wiki
schivata	s̪k̟iväːt̪ä	wiki
schivezza	s̪k̟ivet̪t̪͡s̪ä	wiki
schivo	s̪k̟iːvo	wiki
sciacquabudella	ʃäkkwäbud̪ɛl̺l̺ä	wiki
sciafilo	ʃiäːfil̺o	wiki
scialbare	ʃäl̺bäːr̺e̞	wiki
scialbo	ʃäl̺bo̞	wiki
sciatalgia	ʃät̪äl̺d͡ʒiä̯	wiki
scifo	ʃiːfo	wiki
scimia	ʃiːmjä	wiki
scindere	ʃin̪d̪er̺e	wiki
sciocco	ʃɔkko	wiki
sciofilo	ʃiɔːfil̺o	wiki
sciogun	ʃoɡun̺	wiki
sciogunale	ʃoɡun̺äːl̺e̞	wiki
sciogunato	ʃoɡun̺äːt̪o̞	wiki
scipione	ʃipjoːn̺e	wiki
scipito	ʃipito	wiki
scissile	ʃis̪s̪il̺e	wiki
scleradenite	s̪kl̺er̺äd̪e̞n̺iːt̪e	wiki
scleroadenite	s̪kl̺er̺oäd̪e̞n̺iːt̪e	wiki
scleroblastema	s̪kl̺er̺obl̺äs̪t̪ɛːmä	wiki
scleroblasto	s̪kl̺er̺obl̺äs̪t̪o̞	wiki
sclerocarpo	s̪kl̺er̺okär̺po̞	wiki
sclerodattilia	s̪kl̺er̺od̪ät̪t̪il̺iːä	wiki
sclerodermia	s̪kl̺er̺od̪er̺miːä	wiki
sclerodermico	s̪kl̺er̺od̪ɛr̺miko	wiki
sclerofillo	s̪kl̺er̺ofil̺l̺o	wiki
sclerometria	s̪kl̺er̺omet̪r̺iːä	wiki
sclerometro	s̪kl̺er̺ɔːmet̪r̺o	wiki
scoglia	s̪kɔʎʎä	wiki
scola	s̪koːl̺ä	wiki
scola	s̪kɔːl̺ä	wiki
scolca	s̪kol̺kä	wiki
scolta	s̪kol̪t̪ä	wiki
scolto	s̪kol̪t̪o	wiki
scompigliare	s̪kompiʎʎäːr̺e̞	wiki
scongiurabile	s̪kon̺ʲd͡ʒur̺äːbil̺e̞	wiki
scongiuramento	s̪kon̺ʲd͡ʒur̺äme̞n̪t̪o	wiki
scongiurare	s̪kon̺ʲd͡ʒur̺äːr̺e̞	wiki
scongiuratore	s̪kon̺ʲd͡ʒur̺ät̪o̞ːr̺e	wiki
scongiurazione	s̪kon̺ʲd͡ʒur̺ät̪t̪͡s̪joːn̺e	wiki
scongiuro	s̪kon̺ʲd͡ʒuːr̺o	wiki
sconoscere	s̪kon̺oʃʃer̺e	wiki
scooter	s̪kuːt̪er̺	wiki
scooterista	s̪kut̪er̺is̪t̪ä	wiki
scopiazzare	s̪kopjät̪͡ːs̪äːr̺e̞	wiki
scoppiettare	s̪koppjet̪t̪äːr̺e̞	wiki
scoppiettiere	s̪koppjet̪t̪jɛːr̺e	wiki
scopula	s̪kɔːpul̺ä	wiki
scoreggia	s̪kor̺edd͡ʒa	wiki
scoreggiare	s̪kor̺edd͡ʒaːr̺e	wiki
scorfano	s̪kɔr̺fän̺o̞	wiki
scorgere	s̪kɔr̺d͡ʒer̺e	wiki
scorpena	s̪kor̺pɛːn̺ä	wiki
scorpena	s̪kɔr̺pen̺ä	wiki
scorreggia	s̪kor̺r̺ed͡ːʒä	wiki
scorta	s̪kɔr̺t̪ä	wiki
scorto	s̪kor̺t̪o	wiki
scorto	s̪kɔr̺t̪o	wiki
scoticamento	s̪kot̪ikäme̞n̪t̪o	wiki
scoticare	s̪kot̪ikäːr̺e̞	wiki
scottadito	s̪kɔt̪ːäd̪iːt̪o	wiki
scottare	s̪kot̪t̪äːr̺e̞	wiki
scottarsi	s̪kot̪t̪är̺s̪i	wiki
scotto	s̪kɔt̪t̪o	wiki
scout	s̪käu̯t̪	wiki
scozia	s̪kɔt̪͡ːs̪jä	wiki
scribacchiare	s̪kr̺ibakk̟jaːr̺e	wiki
scribacchino	s̪kr̺ibakk̟in̺o	wiki
scribacchino	s̪kr̺ibakk̟iːn̺o	wiki
scrivibile	s̪kr̺iviːbil̺e	wiki
scudiscio	s̪kud̪iʃːo	wiki
scudo	s̪kuːd̪o	wiki
scudocrociata	s̪kud̪okr̺ot͡ʃäːt̪ä	wiki
scudocrociato	s̪kud̪okr̺ot͡ʃäːt̪o̞	wiki
sculdascia	s̪kul̪d̪äʃʃiːä	wiki
sculdascia	s̪kul̪d̪äʃʃä	wiki
sculdascio	s̪kul̪d̪äʃʃo̞	wiki
sculto	s̪kul̪t̪o	wiki
scuola	s̪kwɔːl̺ä	wiki
sdondolare	z̪d̪on̪d̪ol̺äːr̺e̞	wiki
sdrucciolo	z̪d̪r̺utt͡ʃol̺o	wiki
sdrumare	z̪d̪r̺umäːr̺e̞	wiki
sdrumato	z̪d̪r̺umäːt̪o̞	wiki
sebbene	s̪ebbɛːn̺e	wiki
secare	s̪ekäːr̺e̞	wiki
secchezza	sek̟ːet̪͡s̪ːä	wiki
secco	sekko	wiki
seco	s̪eːko	wiki
secolo	sɛkolo	wiki
secondario	s̪ekon̪d̪aːr̺i̯o	wiki
secondo	s̪ekon̪d̪o	wiki
secretagogo	s̪ekr̺et̪äɡɔːɡo	wiki
sedici	seːd̪it͡ʃi	wiki
sedio	s̪ɛːd̪jo	wiki
seghidiglia	s̪eɡ̟id̪iʎʎä	wiki
segnacolo	s̪eɲɲäːko̞l̺o	wiki
segno	s̪eɲːo	wiki
segnore	s̪eɲɲoːr̺e	wiki
seguire	s̪eɡwiːr̺e	wiki
sei	s̪ɛi̯	wiki
seicento	s̪ei̯t͡ʃɛn̪t̪o	wiki
seicento	s̪ɛi̯t͡ʃɛn̪t̪o	wiki
selenio	s̪el̺ɛːn̺jo	wiki
selenite	s̪el̺en̺iːt̪e	wiki
selva	s̪el̺vä	wiki
selvaggio	s̪el̺vädd͡ʒo̞	wiki
sembiante	s̪embjan̪t̪e	wiki
semblante	s̪embl̺an̪t̪e	wiki
seme	seme	wiki
semiesagono	s̪emiez̪äːɡon̺o	wiki
semiramide	s̪emir̺äːmid̪e	wiki
semiramìs	s̪emir̺ämis̪	wiki
senape	sɛːnape	wiki
sene	s̪ɛːn̺e	wiki
senecione	s̪en̺et͡ʃoːn̺e	wiki
senescente	s̪en̺eʃʃɛn̪t̪e	wiki
senescenza	s̪en̺eʃʃɛn̪t̪͡s̪ä	wiki
senetta	s̪en̺ɛt̪t̪ä	wiki
senettude	s̪en̺et̪t̪uːd̪e	wiki
senettute	s̪en̺et̪t̪uːt̪e	wiki
senettù	s̪en̺et̪t̪u	wiki
seni	s̪eːn̺i	wiki
seni	s̪ɛːn̺i	wiki
senio	s̪ɛːn̺jo	wiki
senna	s̪ɛn̺n̺ä	wiki
senza	s̪en̪t̪͡s̪a	wiki
senza	s̪ɛn̪t̪͡s̪a	wiki
sera	seːra	wiki
seraficamente	s̪er̺äfikäme̞n̪t̪e	wiki
serafico	s̪er̺äːfiko	wiki
sere	seːre	wiki
sermo	s̪ɛr̺mo	wiki
sermonare	s̪er̺mon̺äːr̺e̞	wiki
sermone	s̪er̺moːn̺e	wiki
serpente	s̪er̺pɛn̪t̪e	wiki
serva	s̪ɛr̺vä	wiki
servo	s̪ɛr̺vo	wiki
sescuncia	s̪es̪kun̺ʲt͡ʃä	wiki
sesquipedale	s̪es̪kwiped̪äːl̺e̞	wiki
sesterno	s̪es̪t̪ɛr̺n̺o	wiki
sette	s̪ɛt̪t̪e	wiki
settembre	s̪et̪t̪ɛmbr̺e	wiki
settrice	s̪et̪t̪r̺iːt͡ʃe	wiki
sfagnobrio	s̪fäɲɲɔːbr̺jo	wiki
sfarzo	s̪fär̺t̪͡s̪o	wiki
sfibrare	s̪fibr̺äːr̺e̞	wiki
sfida	s̪fiːd̪ä	wiki
sfidante	s̪fid̪än̪t̪e̞	wiki
sfidare	s̪fid̪äːr̺e̞	wiki
sfidarsi	s̪fid̪är̺s̪i	wiki
sfidato	s̪fid̪äːt̪o̞	wiki
sfidatore	s̪fid̪ät̪o̞ːr̺e	wiki
sfidatrice	s̪fid̪ät̪r̺iːt͡ʃe	wiki
sfiducia	s̪fid̪uːt͡ʃä	wiki
sfiduciare	s̪fid̪ut͡ʃäːr̺e̞	wiki
sfiduciarsi	s̪fid̪ut͡ʃär̺s̪i	wiki
sfiduciato	s̪fid̪ut͡ʃäːt̪o	wiki
sfiducioso	s̪fid̪ut͡ʃoːz̪o	wiki
sforacchiare	s̪for̺äkk̟jäːr̺e̞	wiki
sforacchiatura	s̪for̺äkk̟jät̪uːr̺ä	wiki
sfrangere	s̪fr̺än̺ʲd͡ʒe̞r̺e	wiki
sfrangersi	s̪fr̺än̺ʲd͡ʒe̞r̺s̪i	wiki
sfreddare	s̪fr̺ed̪d̪äːr̺e̞	wiki
sfreddarsi	s̪fr̺ed̪d̪är̺s̪i	wiki
sfrucugliare	s̪fr̺ukuʎʎäːr̺e̞	wiki
sfruculiare	s̪fr̺ukul̺jäːr̺e̞	wiki
sfruguliare	s̪fr̺uɡul̺jäːr̺e̞	wiki
sgabello	zɡabɛl̚lo	wiki
sgambettare	z̪ɡämbet̪t̪äːr̺e̞	wiki
sgambetto	z̪ɡämbe̞t̪t̪o	wiki
sgargiante	z̪ɡär̺d͡ʒän̪t̪e̞	wiki
sgargiare	z̪ɡär̺d͡ʒäːr̺e̞	wiki
sgelare	zdʒelaːre	wiki
sghei	z̪ɡ̟ɛi̯	wiki
sgnaccare	z̪ɲäkkäːr̺e̞	wiki
sgrammaticato	zɡrämːät̪ikäːt̪o	wiki
sgrammaticatura	zɡrämːät̪ikät̪uːrä	wiki
sgrappare	s̪ɡr̺äppäːr̺e̞	wiki
sgrondolare	z̪ɡr̺on̪d̪ol̺äːr̺e̞	wiki
sgusciare	z̪ɡuʃʃäːr̺e̞	wiki
shogun	ʃoɡun̺	wiki
shogunale	ʃoɡun̺äːl̺e̞	wiki
shogunato	ʃoɡun̺äːt̪o̞	wiki
sica	s̪iːkä	wiki
sicario	s̪ikäːr̺jo	wiki
sicomoro	s̪ikomɔːro	wiki
sicomoro	s̪ikɔːmoro̞	wiki
sicumera	s̪ikumɛːr̺ä	wiki
siffredi	s̪iffr̺eːd̪i	wiki
siffredo	s̪iffr̺eːd̪o	wiki
sifrido	s̪ifr̺iːd̪o	wiki
sigaraia	s̪iɡär̺äːjä	wiki
sigaraio	s̪iɡär̺äːjo̞	wiki
sigaretta	s̪iɡär̺e̞t̪t̪ä	wiki
sigaro	s̪iːɡär̺o̞	wiki
sigfredo	s̪iɡfr̺eːd̪o	wiki
sigfrido	s̪iɡfr̺iːd̪o	wiki
sigifredo	s̪id͡ʒifr̺eːd̪o	wiki
sigifrido	s̪id͡ʒifr̺iːd̪o	wiki
sigisfrido	s̪id͡ʒis̪fr̺iːd̪o	wiki
sigma	s̪iɡmä	wiki
sigmacismo	s̪iɡmät͡ʃiz̪mo	wiki
sigmatismo	s̪iɡmät̪iz̪mo	wiki
signacolo	s̪iɲɲäːko̞l̺o	wiki
signaculo	s̪iɲɲäːkul̺o	wiki
signora	s̪iɲɲoːr̺ä	wiki
signore	s̪iɲɲoːr̺e	wiki
sileno	s̪il̺ɛːn̺o	wiki
silicio	sil̺iːt͡ʃo	wiki
silla	silːä	wiki
sillaba	s̪il̺l̺äbä	wiki
sillababile	s̪il̺l̺abaːbil̺e	wiki
sillabazione	sillabatsjone	wiki
silofonista	s̪il̺ofon̺is̪t̪ä	wiki
silofono	s̪il̺ɔːfon̺o	wiki
silvestre	s̪il̺vɛs̪t̪r̺e	wiki
silvestro	s̪il̺vɛs̪t̪r̺o	wiki
simbolo	s̪imbol̺o	wiki
simo	s̪iːmo	wiki
simpatico	simpäːt̪iko	wiki
sinceramente	s̪in̠ʲt͡ʃer̺ämen̪t̪e	wiki
sincero	s̪in̠ʲt͡ʃɛːr̺o	wiki
singolo	s̪iŋɡol̺o	wiki
sinistra	sinistra	wiki
sirima	siːrima	wiki
sirma	sirma	wiki
sito	s̪iːt̪o	wiki
slargando	z̪l̺är̺ɡän̪d̪o̞	wiki
sleale	zleaːle	wiki
slealtà	zlealt̪a	wiki
slivoviz	z̪l̺iːvovit̪͡s̪	wiki
slogan	z̪l̺ɔːɡän̺	wiki
slumacare	z̪l̺umäkäːr̺e̞	wiki
smartphone	z̪mär̺t̪fo̞n̺	wiki
smartphone	z̪mär̺t̪fɔn̺	wiki
smazzare	z̪mät̪t̪͡s̪äːr̺e̞	wiki
smeraldino	z̪mer̺äl̺d̪iːn̺o	wiki
smeraldo	z̪mer̺al̺d̪o	wiki
smeriglio	z̪mer̺iʎʎo	wiki
smodare	z̪mod̪äːr̺e̞	wiki
smoncare	z̪moŋkäːr̺e̞	wiki
smotta	z̪mɔt̪t̪ä	wiki
smottare	z̪mot̪t̪äːr̺e̞	wiki
smungere	z̪mun̺ʲd͡ʒer̺e	wiki
snaturare	z̪n̺ät̪ur̺äːr̺e̞	wiki
snaturatezza	z̪n̺ät̪ur̺ät̪e̞t̪t̪͡s̪ä	wiki
snaturato	z̪n̺ät̪ur̺äːt̪o̞	wiki
snobilitare	z̪n̺obil̺it̪äːr̺e̞	wiki
sobranzare	s̪obr̺än̪t̪͡s̪äːr̺e̞	wiki
socco	s̪ɔkko	wiki
socievole	sot͡ʃeːvole̞	wiki
socio	s̪ɔːt͡ʃo	wiki
sodare	s̪od̪äːr̺e̞	wiki
soddisfare	s̪od̪d̪is̪fäːr̺e	wiki
soddisfatto	s̪od̪d̪is̪fät̪t̪o	wiki
soddisfazione	s̪od̪d̪is̪fät̪͡s̪joːn̺e	wiki
sodio	sɔːd̪jo	wiki
soffiare	soffjare	wiki
soffreddo	s̪offr̺ed̪d̪o	wiki
soffriggere	soffr̺idd͡ʒer̺e	wiki
soffritto	s̪offr̺it̪t̪o	wiki
sofo	s̪ɔːfo	wiki
sofà	s̪ofa	wiki
sofà	s̪ɔfa	wiki
soggiacere	sod̚d͡ʒat͡ʃeːre	wiki
soggolare	s̪oɡɡol̺äːr̺e̞	wiki
soggolo	s̪oɡɡoːl̺o	wiki
sogliola	s̪ɔʎʎol̺ä	wiki
sognare	s̪oɲɲäːr̺e̞	wiki
sogno	s̪oɲɲo	wiki
sole	s̪oːl̺e	wiki
solfo	s̪ol̺fo	wiki
solicello	s̪ol̺it͡ʃɛl̺l̺o	wiki
soliloquio	s̪ol̺il̺ɔːkwjo	wiki
solleccione	s̪ol̺l̺ett͡ʃoːn̺e	wiki
sollo	s̪ol̺ːo	wiki
solo	s̪oːl̺o	wiki
sonnacchiosamente	s̪on̺n̺äkk̟joz̪äme̞n̪t̪e	wiki
sonnacchioso	s̪on̺n̺äkk̟joːz̪o	wiki
sonnecchiare	s̪on̺n̺ekk̟jäːr̺e̞	wiki
sonno	s̪on̺n̺o	wiki
sonnolento	s̪on̺n̺ol̺ɛn̪t̪o	wiki
sonnolenza	s̪on̺n̺ol̺ɛn̪t̪͡s̪ä	wiki
sono	s̪oːn̺o	wiki
sono	s̪ɔːn̺o	wiki
sonorizzazione	s̪on̺or̺id̪͡ːz̪ät̪͡s̪joːn̺e	wiki
sonoro	s̪on̺ɔːr̺o	wiki
sopimento	s̪opimen̪t̪o	wiki
sopore	s̪opoːr̺e	wiki
soporifero	s̪opor̺iːfer̺o	wiki
soprasegnare	s̪opr̺äs̪e̞ɲɲäːr̺e̞	wiki
soprassegnare	s̪opr̺äs̪s̪e̞ɲɲäːr̺e̞	wiki
sopravincere	s̪opr̺ävin̺ʲt͡ʃer̺e	wiki
sopravvincere	s̪opr̺ävvin̺ʲt͡ʃer̺e	wiki
sopravvivere	sopravviːvere	wiki
soqquadro	s̪okkwäːd̪r̺o̞	wiki
soredio	s̪or̺ɛːd̪jo	wiki
sorte	s̪or̺t̪e	wiki
sorte	s̪ɔr̺t̪e	wiki
sortileghi	s̪or̺t̪͡iːl̺eɡi	wiki
sortilegi	s̪or̺t̪͡il̺ɛːd͡ʒi	wiki
sortilegi	s̪or̺t̪͡iːl̺ed͡ʒi	wiki
sortilego	s̪or̺t̪͡iːl̺eɡo	wiki
sorto	s̪or̺t̪o	wiki
sostantivo	s̪os̪t̪än̪t̪iːvo	wiki
sostentacolo	s̪os̪t̪en̪t̪äːko̞l̺o	wiki
sottile	sottile	wiki
sottocategoria	s̪ot̪t̪okät̪e̞ɡor̺iä̯	wiki
sottogenere	s̪ot̪ːod͡ʒɛːn̺er̺e	wiki
sottospecie	s̪ot̪t̪os̪pɛːt͡ʃe	wiki
sottovoce	sot̪ːovoːt͡ʃe	wiki
sottraggere	s̪ot̪t̪r̺ädd͡ʒe̞r̺e̞	wiki
sottrarre	s̪ot̪t̪r̺är̺ːe̞	wiki
sovra	s̪oːvr̺ä	wiki
sovradosare	s̪ovr̺äd̪o̞z̪äːr̺e̞	wiki
sovranzare	s̪ovr̺än̪t̪͡s̪äːr̺e̞	wiki
sozzo	s̪ot̪t̪͡s̪o	wiki
spadona	s̪päd̪o̞ːn̺ä	wiki
spadone	s̪päd̪o̞ːn̺e	wiki
spaghettata	s̪päɡ̟e̞t̪t̪äːt̪ä	wiki
spaghetti	späɡet̪ːi	wiki
spaghetto	s̪päɡ̟e̞t̪t̪o	wiki
spagirico	s̪päd͡ʒiːr̺iko	wiki
spagnola	s̪päɲɲɔːl̺ä	wiki
spagnolo	s̪päɲɲɔːl̺o	wiki
spagnuolo	s̪päɲɲwɔːl̺o	wiki
spandisabbia	s̪pän̪d̪is̪äbːjä	wiki
spantanare	s̪pän̪t̪än̺äːr̺e̞	wiki
sparaneve	s̪pär̺än̺e̞ːve	wiki
sparide	s̪päːr̺id̪e	wiki
sparto	s̪pär̺t̪o̞	wiki
spauracchio	s̪päu̯r̺äkk̟jo	wiki
spaurare	s̪päu̯r̺äːr̺e̞	wiki
spaurarsi	s̪päu̯r̺är̺s̪i	wiki
spaurato	s̪päu̯r̺äːt̪o̞	wiki
spaurevole	s̪päu̯r̺eːvol̺e	wiki
spaurimento	s̪päu̯r̺ime̞n̪t̪o	wiki
spaurire	s̪päu̯r̺iːr̺e	wiki
spaurito	s̪päu̯r̺iːt̪o	wiki
spaventare	s̪päve̞n̪t̪äːr̺e̞	wiki
spazializzare	s̪pät̪t̪͡s̪jäl̺id̪d̪͡z̪äːr̺e̞	wiki
spazializzazione	s̪pät̪t̪͡s̪jäl̺id̪d̪͡z̪ät̪t̪͡s̪joːn̺e̞	wiki
speciale	s̪pet͡ʃäːl̺e̞	wiki
specialmente	s̪pet͡ʃäl̺me̞n̪t̪e	wiki
spelagare	s̪pel̺äɡäːr̺e̞	wiki
spelagarsi	s̪pel̺äɡär̺s̪i	wiki
spergiurare	s̪per̺d͡ʒur̺äːr̺e̞	wiki
spergiuratore	s̪per̺d͡ʒur̺ät̪o̞ːr̺e	wiki
spergiuratrice	s̪per̺d͡ʒur̺ät̪r̺iːt͡ʃe	wiki
spergiuro	s̪per̺d͡ʒuːr̺o	wiki
spermatozoo	s̪per̺mät̪o̞d̪͡z̪ɔːo	wiki
sperto	s̪pɛr̺t̪o	wiki
spiaccicare	s̪pjät͡ːʃikäːr̺e̞	wiki
spiaccicarsi	s̪pjät͡ːʃikär̺s̪i	wiki
spiacente	spjatʃɛnte	wiki
spiaggia	spjaddʒa	wiki
spiede	s̪pjɛːd̪e	wiki
spiedo	s̪pjɛːd̪o	wiki
spiegamento	s̪pjeɡämen̪t̪o	wiki
spiegone	spjeɡoːne	wiki
spillatrice	s̪pil̺l̺ät̪r̺iːt͡ʃe	wiki
spinello	s̪pin̺ɛl̺l̺o	wiki
spingere	spindʒere	wiki
spingidisco	s̪pin̺ʲd͡ʒid̪is̪ko	wiki
spiracolo	s̪pir̺äːko̞l̺o	wiki
spirantizzazione	s̪pir̺än̪t̪id̪͡ːz̪ät̪͡s̪joːn̺e	wiki
splendidamente	s̪pl̺en̪d̪id̪äme̞n̪t̪e	wiki
spogliarello	s̪poʎʎär̺ɛl̺l̺o	wiki
spoltrire	s̪pol̪t̪r̺iːr̺e	wiki
spoltrirsi	s̪pol̪t̪r̺ir̺s̪i	wiki
spoltronire	s̪pol̪t̪r̺on̺iːr̺e	wiki
sporchevole	s̪por̺k̟eːvol̺e	wiki
sporco	spɔrko	wiki
sprazzare	s̪pr̺ät̪t̪͡s̪äːr̺e̞	wiki
sprazzo	s̪pr̺ät̪t̪͡s̪o̞	wiki
spregevole	s̪pr̺ed͡ʒeːvol̺e	wiki
sprezzatura	s̪pr̺et̪t̪͡s̪ät̪uːr̺ä	wiki
sproloquiare	s̪pr̺ol̺ɔkwjaːr̺e	wiki
sproloquiare	s̪pr̺ɔl̺ɔkwjaːr̺e	wiki
sproloquio	s̪pr̺ol̺ɔːkwjo	wiki
sprota	s̪pr̺ɔːt̪ä	wiki
sproto	s̪pr̺ɔːt̪o	wiki
sputacchiare	s̪put̪äkk̟jäːr̺e̞	wiki
sputare	sputare	wiki
squacquerone	skwäkkweroːne	wiki
squadra	s̪kwäːd̪r̺ä	wiki
squadrare	s̪kwäd̪r̺äːr̺e̞	wiki
squalene	s̪kwäl̺ɛːn̺e	wiki
squalide	s̪kwäːl̺id̪e	wiki
squaliforme	s̪kwäl̺ifor̺me	wiki
squallente	s̪kwäl̺l̺ɛn̪t̪e	wiki
squallido	s̪kwäl̺l̺id̪o	wiki
squalo	s̪kwäːl̺o̞	wiki
squarciagola	s̪kwär̺t͡ʃäɡoːl̺ä	wiki
squarciare	s̪kwär̺t͡ʃäːr̺e̞	wiki
squartare	s̪kwär̺t̪äːr̺e̞	wiki
squasso	s̪kwäs̪ːo̞	wiki
squero	s̪kwɛːr̺o	wiki
staccino	s̪t̪ätt͡ʃin̺o	wiki
staccino	s̪t̪ätt͡ʃiːn̺o	wiki
staccio	s̪t̪ätt͡ʃo̞	wiki
stacciolo	s̪t̪ätt͡ʃɔːl̺o	wiki
stacciuolo	s̪t̪ätt͡ʃwɔːl̺o	wiki
stagionale	s̪t̪äd͡ʒo̞n̺äːl̺e̞	wiki
stagionalità	s̪t̪äd͡ʒo̞n̺äl̺it̪ä	wiki
stagionalmente	s̪t̪äd͡ʒo̞n̺äl̺me̞n̪t̪e	wiki
stagione	s̪t̪äd͡ʒo̞ːn̺e	wiki
stagista	s̪t̪äd͡ʒis̪t̪ä	wiki
stagnare	s̪t̪äɲɲäːr̺e̞	wiki
staioro	s̪t̪äjɔːr̺o	wiki
staliniano	s̪t̪äl̺in̺jäːn̺o̞	wiki
stalinismo	s̪t̪al̺in̺iz̪mo	wiki
stalinista	s̪t̪al̺in̺is̪t̪a	wiki
stamberga	s̪t̪ämbɛr̺ɡä	wiki
stare	staːre	wiki
starnutare	s̪t̪är̺n̺ut̪äːr̺e̞	wiki
starnutire	s̪t̪är̺n̺ut̪iːr̺e̞	wiki
stase	st̪ase	wiki
stasse	st̪asːe	wiki
stefano	steːfano	wiki
stenodattilografia	st̪ɛn̺od̪at̪ːil̺oɡr̺äfiːä	wiki
stenoscritto	s̪t̪en̺os̪kr̺it̪t̪o	wiki
steppa	s̪t̪eppä	wiki
steppicursore	st̪epːikursoːre	wiki
steppificazione	s̪t̪eppifikät̪t̪͡s̪joːn̺e	wiki
sternutire	s̪t̪er̺n̺ut̪iːr̺e̞	wiki
sternuto	s̪t̪er̺n̺uːt̪o	wiki
stiavo	st̪jaːvo	wiki
stibonio	s̪t̪ibɔːn̺jo	wiki
stico	s̪t̪iːko	wiki
stiglio	s̪t̪iʎʎo	wiki
stioro	s̪t̪iɔːr̺o	wiki
stivale	st̪iväːle	wiki
stocastico	s̪t̪okäs̪t̪iko	wiki
storia	s̪t̪ɔːr̺jä	wiki
stormo	s̪t̪or̺mo	wiki
storto	s̪t̪ɔr̺t̪o	wiki
stoviglia	s̪t̪oviʎʎä	wiki
stracciare	st̪r̺ät͡ʃːäːr̺e	wiki
stracciatella	st̪rät͡ʃːät̪ɛlːä	wiki
strada	strada	wiki
stradivario	st̪räd̪iväːrjo	wiki
strappalacrime	s̪t̪r̺äppäl̺äːkr̺ime	wiki
stratempo	s̪t̪r̺ät̪ɛmpo	wiki
strimpellare	s̪t̪r̺impel̺l̺äːr̺e̞	wiki
strofinare	strofinare	wiki
stronca	s̪t̪r̺oŋkä	wiki
stronzare	s̪t̪r̺on̪t̪͡s̪aːr̺e̞	wiki
stronzo	s̪t̪r̺on̪t̪͡s̪o	wiki
strumento	s̪t̪r̺umen̪t̪o	wiki
struzzo	s̪t̪r̺ut̪t̪͡s̪o	wiki
stufo	s̪t̪uːfo	wiki
stupido	s̪t̪uːpid̪o	wiki
stupro	s̪t̪uːpr̺o	wiki
suave	s̪uäːve̞	wiki
suave	s̪wäːve̞	wiki
subcostiero	s̪ubkos̪t̪jɛːr̺o	wiki
sublitoraneo	s̪ubl̺it̪or̺än̺e̞o	wiki
succedaneo	s̪ut͡ʃːed̪aːn̺e̯o	wiki
succedaneo	s̪ut͡ʃːed̪äːn̺eo	wiki
succhiasangue	s̪uk̟k̟jäs̪äŋɡwe	wiki
sucido	s̪uːt͡ʃid̪o	wiki
sudicio	s̪uːd̪it͡ʃo	wiki
sudore	sudore	wiki
suesposto	s̪wes̪pos̪t̪o	wiki
suicida	s̪uit͡ʃiːd̪ä	wiki
suicidare	s̪uit͡ʃid̪äːr̺e̞	wiki
suicidario	s̪uit͡ʃid̪äːr̺jo̞	wiki
suicidarsi	s̪uit͡ʃid̪är̺s̪i	wiki
suicidio	s̪uit͡ʃiːd̪jo	wiki
suono	swɔːno	wiki
suovetaurilia	s̪uovet̪äu̯r̺iːl̺jä	wiki
superbo	supɛrbo	wiki
superelastico	s̪uper̺el̺äs̪t̪iko	wiki
superiorità	s̪uper̺jor̺it̪ä	wiki
superscambio	s̪uper̺s̪kämbjo	wiki
suppergiù	s̪upper̺d͡ʒu	wiki
supplì	s̪uppl̺i	wiki
supreme	s̪upr̺ɛːme	wiki
surimi	s̪ur̺iːmi	wiki
sushi	s̪uʃʃi	wiki
susina	susina	wiki
susina	suzina	wiki
suzzacchera	s̪ud̪d̪͡z̪äkke̞r̺ä	wiki
suzzachera	s̪ud̪d̪͡z̪äːke̞r̺ä	wiki
svedese	z̪ved̪eːz̪e	wiki
svegliare	z̪veʎʎäːr̺e̞	wiki
svezia	z̪vɛt̪͡ːs̪jä	wiki
svizzera	z̪vit̪͡ːserä	wiki
tabla	t̪äːbl̺ä	wiki
tacchino	t̪äkːin̺o	wiki
tacchino	t̪äkːiːn̺o	wiki
taccuino	t̪äkkuin̺o	wiki
tacitismo	t̪ät͡ʃit̪iz̪mo	wiki
tafazzismo	t̪äfät̪t̪͡s̪iz̪mo	wiki
tagliasigari	t̪äʎʎäs̪iːɡär̺i	wiki
talcoscisto	t̪äl̺ko̞ʃʃis̪t̪o	wiki
tanca	t̪äŋkä	wiki
tanghero	t̪äŋɡe̞r̺o	wiki
tanghero	t̪äŋɡɛːr̺o	wiki
tanguto	t̪äŋɡut̪o	wiki
tanguto	t̪äŋɡuːt̪o	wiki
tanica	t̪äːn̺ikä	wiki
tantra	t̪än̪t̪r̺ä	wiki
tantrico	t̪än̪t̪r̺iko	wiki
tantrismo	t̪än̪t̪r̺iz̪mo	wiki
tao	t̪äːo	wiki
tarabugio	t̪är̺äbuːd͡ʒo	wiki
tarabuso	t̪är̺äbuːz̪o	wiki
tarallino	t̪ärälːiːno	wiki
tarallo	t̪ärälːo	wiki
taralluccio	t̪ärälːut͡ːʃo	wiki
tardomedievale	t̪är̺d̪o̞med̪jeväːl̺e̞	wiki
tarmare	t̪är̺mäːr̺e̞	wiki
tarsiare	t̪är̺s̪jäːr̺e̞	wiki
tartagliare	t̪är̺t̪äʎʎäːr̺e̞	wiki
tartara	t̪är̺t̪är̺ä	wiki
tartare	t̪är̺t̪är̺	wiki
tartare	t̪är̺t̪är̺e̞̞	wiki
tartufo	t̪är̺t̪uːfo	wiki
tasso	tasso	wiki
tassobarbasso	t̪äs̪ːo̞bär̺bäs̪ːo̞	wiki
tauro	t̪äu̯r̺o	wiki
tautocronismo	t̪äu̯t̪okr̺on̺iz̪mo	wiki
tautocrono	t̪äu̯t̪ɔːkr̺on̺o	wiki
teco	t̪eːko	wiki
tedesco	t̪ed̪es̪ko	wiki
tediare	t̪ed̪jäːr̺e̞	wiki
tediarsi	t̪ed̪jär̺s̪i	wiki
tedio	t̪ɛːd̪jo	wiki
tediosità	t̪ed̪joz̪it̪ä	wiki
tedioso	t̪ed̪joːz̪o	wiki
tegame	t̪eɡäːme̞	wiki
tegumento	t̪eɡumen̪t̪o	wiki
telearma	t̪el̺eär̺mä	wiki
telefonata	t̪el̺efon̺äːt̪ä	wiki
telefonatore	t̪el̺efon̺ät̪o̞ːr̺e	wiki
telefonatrice	t̪el̺efon̺ät̪r̺iːt͡ʃe	wiki
telefonino	t̪el̺efon̺iːn̺o	wiki
telefonino	t̪el̺ɛːfon̺in̺o	wiki
telescritto	t̪el̺es̪kr̺it̪t̪o	wiki
tempo	t̪ɛmpo	wiki
tempura	t̪empuːrä	wiki
tenacolo	t̪en̺äːko̞l̺o	wiki
tencionare	t̪en̠ʲt͡ʃon̺äːr̺e	wiki
tencione	t̪en̠ʲt͡ʃoːn̺e	wiki
tenere	t̪en̺eːr̺e	wiki
tenere	t̪ɛːn̺er̺e	wiki
tenno	t̪ɛn̺n̺o	wiki
tenue	t̪ɛːnue	wiki
tenzonare	t̪en̪t̪͡s̪on̺äːr̺e	wiki
tenzone	t̪en̪t̪͡s̪oːn̺e	wiki
termoclastico	t̪ɛr̺mokl̺äs̪t̪iko	wiki
termonastia	t̪ɛr̺mon̺äs̪t̪iä̯	wiki
termonastia	t̪ɛr̺mon̺äs̪t̪iːä	wiki
termonastico	t̪ɛr̺mon̺äs̪t̪iko	wiki
terra	t̪ɛrra	wiki
terreo	t̪ɛr̺ːeo	wiki
terreo	t̪ɛr̺ːe̯o	wiki
territoriale	t̪er̺r̺it̪or̺jäːl̺e̞	wiki
terzo	t̪ɛr̺t̪͡s̪o	wiki
tesoro	t̪ez̪ɔːr̺o	wiki
tesserandolo	t̪es̪s̪er̺än̪d̪o̞l̺o	wiki
testa	t̪ɛs̪t̪ä	wiki
testeso	t̪es̪t̪eːz̪o	wiki
testimonianza	t̪es̪t̪imon̺jän̪t̪͡s̪ä	wiki
testimoniare	t̪es̪t̪imon̺jäːr̺e̞	wiki
testimonio	t̪es̪t̪imɔːn̺jo	wiki
testuggine	t̪͡es̪t̪͡udd͡ʒin̺e	wiki
testé	t̪es̪t̪e	wiki
tet	t̪ɛt̪	wiki
tetracloruro	t̪et̪r̺äkl̺o̞r̺uːr̺o	wiki
tibicine	t̪ibiːt͡ʃin̺e	wiki
tiburtino	t̪ibur̪t̪iːno	wiki
tigmonastia	t̪iɡmon̺äs̪t̪iä̯	wiki
tigmonastia	t̪iɡmon̺äs̪t̪iːä	wiki
tigmonastico	t̪iɡmon̺äs̪t̪iko	wiki
tipo	t̪iːpo	wiki
tiramisù	t̪iɾämisu	wiki
tirannia	t̪ir̺än̺n̺iːä	wiki
tirare	t̪irare	wiki
titanio	t̪it̪äːn̺jo	wiki
tito	t̪iːt̪o	wiki
tivoli	t̪iːvoli	wiki
tivvù	t̪ivvu	wiki
tivù	t̪ivu	wiki
tocario	t̪okäːr̺jo	wiki
tocchi	tokki	wiki
tocco	tokko	wiki
tofo	t̪ɔːfo	wiki
togliatti	t̪oʎːät̪ːi	wiki
togliattiano	t̪oʎːät̪ːjäːno	wiki
togliere	t̪ɔʎʎer̺e	wiki
tokyo	t̪ɔːk̟jo	wiki
tolemaico	t̪olemäi̯ko	wiki
tollere	t̪ɔl̺l̺er̺e	wiki
tolosa	t̪ol̺oːz̪ä	wiki
tomba	t̪ombä	wiki
tombale	t̪ombäːl̺e̞	wiki
tonnara	t̪on̺n̺äːr̺ä	wiki
tonnarella	t̪on̺n̺är̺ɛl̺l̺ä	wiki
tonnarotto	t̪on̺n̺är̺ɔt̪t̪o	wiki
tonniera	t̪on̺n̺jɛːr̺ä	wiki
tonniero	t̪on̺n̺jɛːr̺o	wiki
tonno	t̪on̺n̺o	wiki
tontina	t̪on̪t̪iːn̺ä	wiki
topaia	t̪opaːi̯a	wiki
torbicolo	t̪or̺biːkol̺o	wiki
torbiera	t̪or̺bjɛːr̺ä	wiki
torboso	t̪or̺boːz̪o	wiki
tordiera	t̪or̺d̪jɛːr̺ä	wiki
tormalina	tor̺mäl̺iːn̺ä	wiki
torre	t̪orːe	wiki
torre	t̪ɔrːe	wiki
torrente	t̪or̺r̺ɛn̪t̪e	wiki
torrentizio	t̪or̺ːen̪t̪it̪͡ːs̪jo	wiki
torrenziale	t̪or̺ːen̪t̪͡s̪jäːl̺e̞	wiki
torrione	t̪orːjoːne	wiki
torte	t̪or̺t̪e	wiki
torte	t̪ɔr̺t̪e	wiki
tortura	t̪or̺t̪uːr̺ä	wiki
torà	t̪͡or̺a	wiki
torà	t̪͡ɔr̺a	wiki
tosca	t̪os̪ka	wiki
tosca	t̪ɔs̪ka	wiki
tosche	t̪os̪k̟e	wiki
tosche	t̪ɔs̪k̟e	wiki
toschi	t̪os̪k̟i	wiki
toschi	t̪ɔs̪k̟i	wiki
tosco	t̪os̪ko	wiki
tosco	t̪ɔs̪ko	wiki
tossico	t̪ɔs̪s̪iko	wiki
tossicodipendente	t̪os̪s̪ikod̪ipen̪d̪ɛn̪t̪e̞	wiki
tossicodipendente	t̪ɔs̪s̪ikod̪ipen̪d̪ɛn̪t̪e̞	wiki
tossicodipendenza	t̪os̪s̪ikod̪ipen̪d̪ɛn̪t̪͡s̪a	wiki
tossicodipendenza	t̪ɔs̪s̪ikod̪ipen̪d̪ɛn̪t̪͡s̪a	wiki
tossicofarmacologia	t̪ɔs̪s̪ikofar̺mako̞l̺od͡ʒiːa̯	wiki
tossicofarmacologico	t̪ɔs̪s̪ikofar̺mako̞l̺ɔːd͡ʒiko	wiki
tossicologia	t̪ɔsːikol̺od͡ʒiːä	wiki
tossicologico	t̪os̪s̪ikol̺ɔːd͡ʒiko	wiki
tossicologo	t̪os̪s̪ikɔːl̺o̞ɡo	wiki
tossizeismo	t̪os̪s̪id̪͡z̪e̯iz̪mo	wiki
tossoide	t̪os̪s̪ɔi̯d̪e	wiki
totem	t̪ɔːt̪em	wiki
totemico	t̪ot̪ɛːmiko	wiki
totemismo	t̪ot̪emiz̪mo	wiki
totocalcio	t̪ot̪okäl̺ʲt͡ʃo̞	wiki
totocalcio	t̪ɔt̪okäl̺ʲt͡ʃo̞	wiki
totò	t̪ot̪ɔ	wiki
traccia	t̪r̺ätt͡ʃä	wiki
trace	t̪r̺äːt͡ʃe̞	wiki
tracio	t̪͡r̺äːt͡ʃo̞	wiki
tradigione	t̪r̺äd̪id͡ʒoːn̺e	wiki
tradizione	t̪r̺äd̪it̪t̪͡s̪joːn̺e	wiki
tragedo	t̪r̺äd͡ʒɛːd̪o	wiki
traggere	t̪r̺ädd͡ʒe̞r̺e	wiki
tralice	t̪r̺al̺iːt͡ʃe	wiki
tralice	t̪r̺aːl̺it͡ʃe	wiki
tramezzino	t̪r̺amed̪d̪͡z̪iːn̺o	wiki
tramezzo	t̪r̺amɛd̪d̪͡z̪o	wiki
tramoggia	t̪r̺ämɔdd͡ʒä	wiki
tramontana	t̪r̺ämon̪t̪äːn̺ä	wiki
tramontano	t̪r̺ämo̞n̪t̪än̺o̞	wiki
tramontano	t̪r̺ämo̞n̪t̪äːn̺o̞	wiki
tranquillamente	t̪r̺äŋkwil̺l̺äme̞n̪t̪e	wiki
tranquillare	t̪r̺äŋkwil̺l̺äːr̺e̞	wiki
tranquillarsi	t̪r̺äŋkwil̺l̺är̺s̪i	wiki
tranquillato	t̪r̺äŋkwil̺l̺äːt̪o̞	wiki
tranquillità	t̪r̺äŋkwil̺l̺it̪ä	wiki
tranquillizzante	t̪r̺äŋkwil̺l̺id̪d̪͡z̪än̪t̪e̞	wiki
tranquillizzare	t̪r̺äŋkwil̺l̺id̪d̪͡z̪äːr̺e̞	wiki
tranquillizzarsi	t̪r̺äŋkwil̺l̺id̪d̪͡z̪är̺s̪i	wiki
tranquillizzato	t̪r̺äŋkwil̺l̺id̪d̪͡z̪äːt̪o̞	wiki
tranquillo	t̪r̺äŋkwil̺l̺o	wiki
transfrastico	t̪r̺än̪s̪fr̺äs̪t̪iko	wiki
transire	t̪r̺än̪s̪iːr̺e	wiki
transito	t̪r̺än̪s̪it̪o	wiki
transito	t̪r̺än̪s̪iːt̪o	wiki
translato	t̪r̺än̪z̪l̺äːt̪o̞	wiki
transtiberino	t̪r̺än̪s̪t̪iber̺iːn̺o	wiki
transubstanziazione	t̪r̺än̪s̪ubs̪t̪än̪t̪͡s̪jät̪͡s̪joːn̺e	wiki
transumano	t̪r̺än̪s̪umäːn̺o̞	wiki
transumanza	t̪r̺än̪s̪umän̪t̪͡s̪ä	wiki
transustanziare	t̪r̺än̪s̪us̪t̪än̪t̪͡s̪jäːr̺e̞	wiki
transustanziarsi	t̪r̺än̪s̪us̪t̪än̪t̪͡s̪jär̺s̪i	wiki
transustanziazione	t̪r̺än̪s̪us̪t̪än̪t̪͡s̪jät̪͡s̪joːn̺e	wiki
trasgressione	t̪r̺äz̪ɡr̺e̞s̪s̪joːn̺e	wiki
traslato	t̪r̺äz̪l̺äːt̪o̞	wiki
trasmodare	t̪r̺äz̪mo̞d̪äːr̺e̞	wiki
trasteverino	t̪r̺äs̪t̪e̞ver̺iːn̺o	wiki
travagliare	t̪r̺äväʎʎäːr̺e̞	wiki
travagliatore	t̪r̺äväʎʎät̪o̞ːr̺e	wiki
travagliatrice	t̪r̺äväʎʎät̪r̺iːt͡ʃe	wiki
travaglio	travaʎʎo	wiki
travicello	t̪r̺ävit͡ʃɛl̺l̺o	wiki
tre	t̪r̺e	wiki
treccia	t̪r̺ett͡ʃä	wiki
tredici	t̪reːd̪it͡ʃi	wiki
tregua	t̪r̺ɛːɡwä	wiki
tremolio	t̪r̺emol̺io̯	wiki
trepidazione	t̪͡r̺epid̪at̪͡s̪joːn̺e	wiki
trespolo	t̪r̺es̪pol̺o	wiki
treviso	t̪r̺eviːz̪o	wiki
triangolo	t̪r̺jäŋɡo̞l̺o	wiki
triblastico	t̪r̺ibl̺äs̪t̪iko	wiki
triegua	t̪r̺jɛːɡwä	wiki
trienne	t̪r̺iɛn̺n̺e	wiki
trifola	t̪r̺iːfol̺ä	wiki
trifolare	t̪r̺ifol̺äːr̺e̞	wiki
trifolato	t̪r̺ifol̺äːt̪o̞	wiki
trinare	t̪r̺in̺äːr̺e̞	wiki
trinazione	t̪r̺in̺ät̪t̪͡s̪joːn̺e	wiki
trinciapollo	t̪r̺in̺ʲt͡ʃäpo̞l̺l̺o	wiki
trino	t̪r̺iːn̺o	wiki
trionfo	t̪r̺joɱfo	wiki
triplo	t̪r̺iːpl̺o	wiki
triploblastico	t̪r̺ipl̺obl̺äs̪t̪iko	wiki
trippa	t̪ripːä	wiki
trirettangolo	t̪r̺ir̺et̪t̪äŋɡo̞l̺o	wiki
trisdrucciolo	t̪r̺iz̪d̪r̺utt͡ʃol̺o	wiki
triste	t̪r̺is̪t̪e	wiki
tritagonista	t̪r̺it̪äɡo̞n̺is̪t̪ä	wiki
trittongo	t̪r̺it̪t̪ɔŋɡo	wiki
trogliare	t̪r̺oʎʎäːr̺e̞	wiki
troglio	t̪r̺ɔʎʎo	wiki
troia	t̪r̺ɔːjä	wiki
tromboplastico	t̪r̺ombopl̺äs̪t̪iko	wiki
tromboplastina	t̪r̺ombopl̺äs̪t̪iːn̺ä	wiki
tronca	t̪r̺oŋkä	wiki
trono	t̪r̺ɔːn̺o	wiki
troppo	t̪rɔppo	wiki
trovadore	t̪r̺oväd̪o̞ːr̺e	wiki
trovatore	t̪r̺ovät̪o̞ːr̺e	wiki
trovatrice	t̪r̺ovät̪r̺iːt͡ʃe	wiki
trovero	t̪r̺ovɛːr̺o	wiki
troviero	t̪r̺ovjɛːr̺o	wiki
truono	t̪r̺wɔːn̺o	wiki
tubicine	t̪ubiːt͡ʃin̺e	wiki
tufo	t̪uːfo	wiki
tundra	t̪un̪d̪r̺ä	wiki
tunnel	t̪unnel	wiki
tuono	t̪u̯ɔːn̺o	wiki
turbazione	t̪ur̺bät̪t̪͡s̪joːn̺e	wiki
turficolo	t̪ur̺fiːkol̺o	wiki
turfofilo	t̪ur̺fɔːfil̺o	wiki
tuscia	tuʃʃa	wiki
tv	t̪ivu	wiki
uanderù	wän̪d̪e̞r̺u	wiki
ubero	ubɛːr̺o	wiki
ubero	uːber̺o	wiki
ubiero	ubjɛːr̺o	wiki
ubriacare	ubr̺iäkäːr̺e̞	wiki
ubriaco	ubr̺iäːko̞	wiki
uccello	utt͡ʃɛl̺l̺o	wiki
uccidere	utt͡ʃiːd̪er̺e	wiki
udire	ud̪iːr̺e	wiki
ufficio	ufːiːt͡ʃo	wiki
ufo	uːfo	wiki
ugna	uɲːä	wiki
uguale	uɡwäːl̺e̞	wiki
ulto	ul̪t̪o	wiki
ultore	ul̪t̪oːr̺e	wiki
ultraterreno	ul̺t̪r̺ät̪e̞r̺r̺eːn̺o	wiki
ultrice	ul̺t̪r̺iːt͡ʃe	wiki
umbonato	umbon̺äːt̪o̞	wiki
umbone	umboːn̺e	wiki
umile	uːmil̺e	wiki
umiliazione	umil̺jät̪͡s̪joːn̺e	wiki
umilmente	umil̺men̪t̪e	wiki
umiltà	umil̺t̪ä	wiki
undici	un̪d̪it͡ʃi	wiki
ungere	un̺ʲd͡ʒer̺e	wiki
ungherese	uŋɡ̟er̺eːz̪e	wiki
unghia	uŋɡ̟jä	wiki
unguentaceo	uŋɡwen̪t̪äːt͡ʃe̞o̯	wiki
unguentaio	uŋɡwen̪t̪äːjo	wiki
unguentario	uŋɡwen̪t̪äːr̺jo	wiki
unguento	uŋɡwɛn̪t̪o	wiki
univocamente	un̺ivokäme̞n̪t̪e	wiki
univocità	un̺ivot͡ʃit̪ä	wiki
univoco	un̺iːvoko	wiki
uno	uːn̺o	wiki
unqua	uŋkwä	wiki
unque	uŋkwe	wiki
ununoctio	un̪un̪ɔkt̪jo	wiki
ununseptio	un̪un̪s̪ɛpt̪jo	wiki
uomo	wɔːmo	wiki
uovo	wɔːvo	wiki
uppsala	upsäːlä	wiki
uragano	uraɡano	wiki
urano	ur̺äːn̺o̞	wiki
urbanizzare	ur̺bän̺id̪͡ːz̪äːr̺e̞	wiki
urbano	ur̺bäːn̺o̞	wiki
urbe	ur̺be	wiki
ureo	ur̺ɛo̯	wiki
ureo	ur̺ɛːo	wiki
uria	uːr̺jä	wiki
urlare	ur̺l̺äːr̺e̞	wiki
urletto	ur̺l̺et̪t̪o	wiki
urlo	ur̺l̺o	wiki
urolagnia	ur̺ol̺äɲɲiä̯	wiki
usbergo	uz̪bɛr̺ɡo	wiki
usignolo	uz̪iɲɲɔːl̺o	wiki
usignuolo	uz̪iɲɲwɔːl̺o	wiki
ussaro	us̪s̪är̺o̞	wiki
ustascia	us̪t̪äʃʃä	wiki
usto	us̪t̪o	wiki
usuale	uz̪uäːl̺e̞	wiki
usuale	uz̪wäːl̺e̞	wiki
usualità	uz̪uäl̺it̪ä	wiki
usualità	uz̪wäl̺it̪ä	wiki
utensile	ut̪en̪s̪iːl̺e	wiki
utensile	ut̪ɛn̪s̪il̺e	wiki
utopia	ut̪opiä̯	wiki
utopia	ut̪opiːä	wiki
uva	uːvä	wiki
uvero	uːver̺o	wiki
uxoricidio	uks̪or̺it͡ʃiːd̪jo	wiki
uzza	ud̪͡ːz̪ä	wiki
vacanza	väkän̪t̪͡s̪ä	wiki
vacanziere	väkän̪t̪͡s̪jɛːr̺e	wiki
vacanziero	väkän̪t̪͡s̪jɛːr̺o	wiki
vaccinaro	vät͡ːʃinäːro	wiki
vademecum	väd̪e̞mɛːkum	wiki
valdostano	väl̪d̪ost̪äːno	wiki
valere	val̺eːr̺e	wiki
valerio	valɛːri̯o	wiki
valle	väl̺l̺e̞	wiki
valligiano	väl̺l̺id͡ʒäːn̺o̞	wiki
vanadio	vän̺äːd̪jo	wiki
vanderù	vän̪d̪e̞r̺u	wiki
vanni	vän̺n̺i	wiki
vario	väːr̺jo̞	wiki
variolizzazione	vär̺jol̺id̪d̪͡z̪ät̪t̪͡s̪joːn̺e	wiki
variometro	vär̺jɔːmet̪r̺o	wiki
varsavia	vär̺s̪äːvjä	wiki
vascello	väʃʃɛl̺l̺o	wiki
vasodilatatore	vaz̪od̪il̺at̪at̪͡oːr̺e	wiki
vasodilatazione	vaz̪od̪il̺at̪at̪͡s̪i̯oːn̺e	wiki
vau	väu̯	wiki
vecchi	vekk̟i	wiki
vecchi	vɛkk̟i	wiki
vecchia	vɛkk̟jä	wiki
vecchiaccia	vekk̟jätt͡ʃä	wiki
vecchiaccio	vekk̟jätt͡ʃo̞	wiki
vecchiaia	vekk̟jäːjä	wiki
vecchierella	vekk̟jer̺ɛl̺l̺ä	wiki
vecchierello	vekk̟jer̺ɛl̺l̺o	wiki
vecchietta	vekk̟jet̪t̪ä	wiki
vecchietto	vekk̟jet̪t̪o	wiki
vecchiezza	vekk̟jet̪t̪͡s̪ä	wiki
vecchio	vekk̟jo	wiki
vecchio	vɛkk̟jo	wiki
vecchiona	vekk̟joːn̺ä	wiki
vecchione	vekk̟joːn̺e	wiki
vecchiotto	vekk̟jɔt̪t̪o	wiki
vecchiume	vekk̟juːme	wiki
vedere	ved̪eːr̺e	wiki
velame	vel̺äːme̞	wiki
velare	vel̺äːr̺e̞	wiki
veleno	vel̺eːn̺o	wiki
velite	vɛːl̺it̪e	wiki
vellerismo	vel̺l̺er̺iz̪mo	wiki
veltra	vɛl̺t̪r̺ä	wiki
veltro	vɛl̺t̪r̺o	wiki
venabulo	ven̺äːbul̺o	wiki
venagione	ven̺äd͡ʒo̞ːn̺e	wiki
venare	ven̺äːr̺e̞	wiki
vendetta	ven̪d̪et̪ːä	wiki
vendicabile	ven̪d̪ikäːbil̺e	wiki
vendicatività	ven̪d̪ikät̪ivit̪ä	wiki
vendicativo	ven̪d̪ikät̪iːvo	wiki
vendicato	ven̪d̪ikäːt̪o̞	wiki
vendichevole	ven̪d̪ikeːvol̺e	wiki
venerdì	ven̺er̺d̪i	wiki
venere	vɛːn̺er̺e	wiki
venticello	ven̪t̪it͡ʃɛl̺l̺o	wiki
ventiquattresimo	ven̪t̪ikwät̪t̪r̺eːz̪imo	wiki
ventiquattro	ven̪t̪ikwät̪t̪r̺o̞	wiki
ventisettana	ven̪t̪iset̪ːäːnä	wiki
ventitreesimo	ven̪t̪it̪r̺eeːz̪imo	wiki
vento	vɛn̪t̪o	wiki
venturo	ven̪t̪uːr̺o	wiki
venusto	ven̺us̪t̪o	wiki
venustà	ven̺us̪t̪ä	wiki
vera	veːr̺ä	wiki
verace	ver̺äːt͡ʃe̞	wiki
verbale	ver̺bäːl̺e̞	wiki
verbo	vɛr̺bo	wiki
verdacchio	ver̺d̪äkk̟jo	wiki
verdegiallo	ver̺d̪ed͡ʒäl̺ːo̞	wiki
verdesca	ver̺d̪es̪kä	wiki
verdona	ver̺d̪oːn̺ä	wiki
verdone	ver̺d̪oːn̺e	wiki
verghiano	verɡ̟jäːno	wiki
vergine	ver̺d͡ʒin̺e	wiki
vergineo	ver̺d͡ʒiːn̺eo	wiki
vergineo	ver̺d͡ʒiːn̺e̯o	wiki
vergogna	ver̺ɡoɲɲä	wiki
vergolare	ver̺ɡol̺äːr̺e̞	wiki
verina	ver̺iːn̺ä	wiki
vernale	ver̺n̺äːle̞	wiki
vernare	ver̺n̺äːr̺e̞	wiki
vero	veːro̞	wiki
versace	versaːtʃe	wiki
versatile	versaːt̪ile	wiki
versicolore	ver̺s̪ikol̺oːr̺e	wiki
vertiginoso	ver̺t̪id͡ʒin̺oːz̪o	wiki
veruno	ver̺uːn̺o	wiki
verzelata	ver̺d̪͡z̪el̺äːt̪ä	wiki
verzelato	ver̺d̪͡z̪el̺äːt̪o̞	wiki
verzellina	ver̺d̪͡z̪el̺l̺iːn̺ä	wiki
verzellino	ver̺d̪͡z̪el̺l̺iːn̺o	wiki
vescicaria	veʃʃikäːr̺jä	wiki
vescovo	veskovo	wiki
vessillo	vessillo	wiki
veterano	vet̪er̺äːn̺o̞	wiki
vetro	veːt̪r̺o	wiki
vetusto	vet̪us̪t̪o	wiki
vetustà	vet̪us̪t̪ä	wiki
vi	vi	wiki
viatico	vjäːt̪iko	wiki
vichingo	vikiŋɡo	wiki
vicino	vitʃino	wiki
vico	viːko	wiki
videogame	vid̪e̯oɡei̯m	wiki
vieto	vjɛːt̪o	wiki
vietume	vjet̪uːme	wiki
vigesimo	vid͡ʒeːz̪imo	wiki
villa	vil̺l̺ä	wiki
vilucchio	vil̺ukk̟jo	wiki
vinciano	vin̠ʲt͡ʃäːno	wiki
vindice	vin̪d̪it͡ʃe	wiki
vino	viːn̺o	wiki
vinsantaia	vinsän̪t̪äːjä	wiki
vipistrello	vipis̪t̪r̺ɛl̺l̺o	wiki
virgineo	vir̺d͡ʒiːn̺eo	wiki
virgineo	vir̺d͡ʒiːn̺e̯o	wiki
viro	viːr̺o	wiki
virtudioso	vir̺t̪ud̪joːz̪o	wiki
viscoplastico	vis̪kopl̺äs̪t̪iko	wiki
visione	vizjoːne	wiki
visitatore	viz̪it̪ät̪o̞ːr̺e	wiki
vispistrello	vis̪pis̪t̪r̺ɛl̺l̺o	wiki
vita	viːt̪ä	wiki
vitroclastico	vit̪r̺okl̺äs̪t̪iko	wiki
vivacchiare	viväkk̟jäːr̺e̞	wiki
vivere	viːveɾe	wiki
vivido	viːvid̪o	wiki
vivo	viːvo	wiki
vizio	vit̪͡ːs̪jo	wiki
vocabolario	vokäbo̞l̺äːr̺jo	wiki
vocabolarista	vokäbo̞l̺är̺is̪t̪ä	wiki
vocabolo	vokäːbo̞l̺o	wiki
vocabulo	vokäːbul̺o	wiki
vocale	vokäːl̺e̞	wiki
vocalico	vokäːl̺iko	wiki
vocare	vokäːr̺e̞	wiki
vocativo	vokät̪iːvo	wiki
vocazione	vokät̪͡s̪joːn̺e	wiki
voce	voːt͡ʃe	wiki
voci	vot͡ʃi	wiki
voci	voːt͡ʃi	wiki
vociante	vot͡ʃän̪t̪e̞	wiki
vociare	vot͡ʃäːr̺e̞	wiki
vociatore	vot͡ʃät̪o̞ːr̺e	wiki
vocio	vot͡ʃio̯	wiki
vocio	voːt͡ʃo	wiki
voduismo	vod̪uiz̪mo	wiki
voduista	vod̪uis̪ta	wiki
voi	voi	wiki
volentieri	vol̺en̪t̪jɛːr̺i	wiki
voliera	vol̺jɛːr̺ä	wiki
volontieri	vol̺on̪t̪jɛːr̺i	wiki
volpacchiotto	vol̺päkk̟jɔt̪t̪o	wiki
volpina	vol̺piːn̺ä	wiki
volto	vol̪t̪o	wiki
volto	vɔl̪t̪o	wiki
volva	vɔl̺vä	wiki
volvere	vɔl̺ver̺e	wiki
vora	voːr̺ä	wiki
vora	vɔːr̺ä	wiki
voracità	vor̺ät͡ʃit̪ä	wiki
voragine	vor̺äːd͡ʒin̺e	wiki
voraginoso	vor̺äɡin̺oz̪o	wiki
vorago	vor̺äːɡo̞	wiki
vorare	vor̺äːr̺e̞	wiki
voratore	vor̺ät̪o̞ːr̺e	wiki
voratrice	vor̺ät̪r̺iːt͡ʃe	wiki
vosco	vɔs̪ko	wiki
votiaco	vot̪jäːko̞	wiki
voucher	väu̯t͡ʃer̺	wiki
vuduismo	vud̪uiz̪mo	wiki
vuduista	vud̪uis̪t̪ä	wiki
vulgata	vul̺ɡäːt̪ä	wiki
vulnerante	vul̺n̺er̺än̪t̪e̞	wiki
vulnerare	vul̺n̺er̺äːr̺e̞	wiki
vulva	vul̺vä	wiki
w	v	wiki
w	w	wiki
wagnerite	väɡn̺e̞r̺iːt̪e	wiki
walkman	wɔl̺kmen̺	wiki
walter	väl̪t̪er	wiki
water	väːt̪er	wiki
weekend	wikɛn̪d̪	wiki
wellerismo	vel̺l̺er̺iz̪mo	wiki
wellerismo	wel̺l̺er̺iz̪mo	wiki
wikizionario	wik̟it̪͡ːs̪jonäːrjo	wiki
x	ks	wiki
xi	ks̪i	wiki
xilofonista	ks̪il̺ofon̺is̪t̪ä	wiki
xilofono	ks̪il̺ɔːfon̺o	wiki
y	i	wiki
y	j	wiki
yogurt	jɔːɡur̺t̪	wiki
ypsilon	ips̪il̺on̺	wiki
zabaglione	d̪͡z̪äbäʎːoːne	wiki
zabaione	d̪͡z̪äbäjoːne	wiki
zafferano	d̪͡z̪äffe̞r̺äːn̺o̞	wiki
zagaglia	d̪͡z̪äɡäʎʎä	wiki
zagana	d̪͡z̪äːɡän̺ä	wiki
zaganella	d̪͡z̪äɡän̺ɛl̺l̺ä	wiki
zagara	d̪͡z̪äːɡärä	wiki
zamberlucco	d̪͡z̪ämbe̞r̺l̺ukko	wiki
zambra	d͡zämbr̺ä	wiki
zanca	d̪͡z̪äŋkä	wiki
zancle	d̪͡z̪äŋkl̺e̞	wiki
zancleana	d̪͡z̪äŋkl̺e̞äːn̺ä	wiki
zancleane	d̪͡z̪äŋkl̺e̞äːn̺e̞	wiki
zancleani	d̪͡z̪äŋkl̺e̞äːn̺i	wiki
zancleano	d̪͡z̪äŋkl̺e̞äːn̺o̞	wiki
zanna	d̪͡z̪än̺n̺ä	wiki
zanna	t̪͡s̪än̺n̺ä	wiki
zannata	d̪͡z̪än̺n̺äːt̪ä	wiki
zannata	t̪͡s̪än̺n̺äːt̪ä	wiki
zanni	d̪͡z̪än̺n̺i	wiki
zannuto	d̪͡z̪än̺n̺uːt̪o	wiki
zannuto	t̪͡s̪än̺n̺uːt̪o	wiki
zanzara	d̪͡z̪än̪d̪͡z̪äːr̺ä	wiki
zappa	t̪͡s̪äppä	wiki
zar	d̪͡z̪är̺	wiki
zar	t̪͡s̪är̺	wiki
zara	d̪͡z̪äːr̺ä	wiki
zaro	d̪͡z̪äːr̺o̞	wiki
zea	d̪͡z̪ɛä̯	wiki
zecca	d̪͡z̪ekkä	wiki
zecca	t̪͡s̪ekkä	wiki
zefiro	d̪͡z̪ɛːfir̺o	wiki
zeno	d̪͡z̪ɛːn̺o	wiki
zenzero	d͡zɛnd͡zero	wiki
zero	d̪͡z̪ɛːr̺o	wiki
zeta	d̪͡z̪ɛːt̪ä	wiki
zeugma	d̪͡z̪ɛu̯ɡmä	wiki
zibaldone	d̪͡z̪ibäl̪d̪oːn̺e	wiki
zigano	t̪͡s̪iɡäːn̺o̞	wiki
zincografia	d̪͡z̪iŋkoɡr̺äfiːä	wiki
zincografia	t̪͡s̪iŋkoɡr̺äfiːä	wiki
zincotipia	d̪͡z̪iŋkot̪ipiːä	wiki
zincotipia	t̪͡s̪iŋkot̪ipiːä	wiki
zingano	d̪͡z̪iŋɡän̺o̞	wiki
zingano	t̪͡s̪iŋɡän̺o̞	wiki
zingaro	d̪͡z̪iŋɡär̺o̞	wiki
zingaro	t̪͡s̪iŋɡär̺o̞	wiki
zirconio	d̪͡z̪irkɔːnjo	wiki
ziro	d̪͡z̪iːr̺o	wiki
zita	d̪͡z̪iːt̪ä	wiki
zita	t̪͡s̪iːt̪ä	wiki
zito	d̪͡z̪iːt̪o	wiki
zito	t̪͡s̪iːt̪o	wiki
zitona	d̪͡z̪it̪oːnä	wiki
zitona	t̪͡s̪it̪oːnä	wiki
zitone	d̪͡z̪it̪oːne	wiki
zitone	t̪͡s̪it̪oːne	wiki
zizzania	d̪͡z̪id̪d̪͡z̪äːn̺jä	wiki
zoccolio	t̪͡s̪okkol̺io̯	wiki
zoccolio	t̪͡s̪okkol̺iːo	wiki
zoomare	d̪͡z̪umäːr̺e̞	wiki
zozza	d̪͡z̪ɔd̪d̪͡z̪ä	wiki
zozza	t̪͡s̪ot̪t̪͡s̪ä	wiki
zozzo	t̪͡s̪ot̪t̪͡s̪o	wiki
zuavo	d̪͡z̪uäːvo̞	wiki
zuavo	d̪͡z̪wäːvo̞	wiki
zuffa	d̪͡z̪uffä	wiki
zuffa	t̪͡s̪uffä	wiki
zufolare	d̪͡z̪ufol̺äːr̺e̞	wiki
zufolare	t̪͡s̪ufol̺äːr̺e̞	wiki
zuppa	t̪͡s̪upːä	wiki
zuzzurullone	d̪͡z̪ud̪͡ːz̪ur̺ul̺l̺oːn̺e	wiki
