abade	/ɐβaðɨ/	wiki
abadessa	/aβɐðesɐ/	wiki
abadia	/ɐβɐðiɐ/	wiki
abafada	/ɐβɐfaðɐ/	wiki
abafadamente	/ɐβɐfaðɐmẽtɨ/	wiki
abafadiço	/ɐβɐfɐðisu/	wiki
abafado	/ɐβɐfaðu/	wiki
abafador	/ɐβɐfɐðoɾ/	wiki
abafar	/ɐβɐfaɾ/	wiki
abafação	/ɐβɐfɐsɐ̃w̃/	wiki
abaixamento	/ɐβajʃɐmẽtu/	wiki
abaixar	/ɐβɐjʃaɾ/	wiki
abalar	/ɐβɐlaɾ/	wiki
abalava	/ɐβɐlavɐ/	wiki
abalou	/ɐβɐlow/	wiki
abanar	/ɐβɐnaɾ/	wiki
abandonar	/ɐβɐ̃dunaɾ/	wiki
abarcar	/abɐɾkaɾ/	wiki
abatedouro	/abatɯdowɾu/	wiki
abater	/ɐβɐteɾ/	wiki
abjurar	/abʒuɾaɾ/	wiki
abotoar	/ɐβutwaɾ/	wiki
abraçar	/ɐβɾɐsaɾ/	wiki
abrigar	/ɐβɾiɣaɾ/	wiki
absorver	/ɐbsoɾveɾ/	wiki
abundante	/ɐβũdɐ̃tɨ/	wiki
abundar	/ɐβũdaɾ/	wiki
abundância	/ɐβũdɐ̃sjɐ/	wiki
acabamento	/akabɐmẽtʊ/	wiki
académico	/ɐkɐðɛmiku/	wiki
acanhado	/ɐkɐɲaðu/	wiki
acinzentar	/ɐsĩzẽtaɾ/	wiki
aclimatar	/aklɨmɐtaɾ/	wiki
aclimatação	/aklɨmatɐsɐ̃w/	wiki
aconselháveis	/ɐkõsɨʎävɛi̯ʃ/	wiki
acoplar	/akoplaɾ/	wiki
acordar	/ɐkuɾðaɾ/	wiki
acta	/atɐ/	wiki
actínio	/ɐktinju/	wiki
acumular	/ɐkumulaɾ/	wiki
acusador	/ɐkuzɐðoɾ/	wiki
adaga	/ɐdaɡɐ/	wiki
adaptar	/adaptaɾ/	wiki
adenina	/əðɯ̽ninə/	wiki
adicional	/ɐðisjunaɫ/	wiki
administrador	/ɐdminiʃtɾɐðoɾ/	wiki
administração	/ɐdminiʃtɾɐsɐ̃w̃/	wiki
advogado	/ɐdvuɣaðu/	wiki
afetação	/afɯtasɐ̃w/	wiki
afluente	/ɐfluẽtɯ/	wiki
afronta	/ɐfɾõtɐ/	wiki
afrouxar	/afɾowʃaɾ/	wiki
agachar	/ɐɣaʃaɾ/	wiki
agenda	/ɐʒẽdɐ/	wiki
agente	/ɐʒẽtɨ/	wiki
agnosticismo	/ɐɣnɔʃtisiʒmu/	wiki
agonia	/ɐɣuniɐ/	wiki
agourar	/ɐɣowɾaɾ/	wiki
agouro	/ɐɣowɾu/	wiki
agrafador	/ɐɣɾɐfɐðoɾ/	wiki
agrafo	/ɐɣɾafu/	wiki
aguadeiro	/aɣwɐðɐjɾu/	wiki
aguar	/ɐɣwaɾ/	wiki
agulha	/ɐɡuʎɐ/	wiki
ai	/aj/	wiki
ainu	/ajnu/	wiki
alativo	/ɐlɐtivu/	wiki
albatroz	/aɫβɐtɾɔʃ/	wiki
alcano	/aɫkɐnu/	wiki
alceno	/aɫsenʊ/	wiki
alerta	/alɛɾtɐ/	wiki
aleúte	/ɐlɨutɨ/	wiki
alfabético	/aɫfɐbɛtiku/	wiki
alferes	/aɫfeɾɪʃ/	wiki
alfinete	/aɫfinetɨ/	wiki
alga	/aɫɡɐ/	wiki
algodão	/aɫɡudɐ̃w̃/	wiki
alguma	/aɫɣumɐ/	wiki
algumas	/aɫɣumɐʃ/	wiki
alguns	/aɫɣũʃ/	wiki
aljava	/aɫʒavɐ/	wiki
alocar	/ɐlukaɾ/	wiki
alquimia	/aɫkɨmiɐ/	wiki
alternativo	/aɫtɨɾnɐtivu/	wiki
altruísmo	/aɫtɾuɨʃmu/	wiki
altímetro	/aɫtimɨtɾu/	wiki
alucinação	/alusɨnasɐ̃w/	wiki
alugar	/ɐluɣaɾ/	wiki
aluguer	/ɐluɣɛɾ/	wiki
alumínio	/aluminɨu/	wiki
amadurecer	/ɐmɐðuɾɨseɾ/	wiki
amamentar	/ɐmɐmẽtaɾ/	wiki
ambientalista	/ɐ̃bɨẽtɐlɨʃtɐ/	wiki
ameaçar	/ɐmjɐsaɾ/	wiki
amerício	/amɯɾisɨu/	wiki
amiúde	/ɐmjuðɨ/	wiki
analogia	/ɐnaloʒiɐ/	wiki
anarquismo	/anɐɾkiʃmu/	wiki
angiosperma	/ɐ̃ʒjoʃpɛɾmɐ/	wiki
anglicano	/ɐ̃ɡlikɐnu/	wiki
anglicismo	/ɐ̃ɡlɨsiʃmu/	wiki
anglo	/ɐ̃ɡlʊ/	wiki
angélico	/ɐ̃ʒɛlɨku/	wiki
anormalidade	/ɐnɔɾmɐliðaðɯ/	wiki
ansiedade	/ɐ̃sjɛðaðɯ̽/	wiki
antagonista	/ɐ̃taɡoniʃtɐ/	wiki
antepenúltimo	/ɐ̃tɯpɯnuɫtɨmu/	wiki
anticorpo	/ɐ̃tikoɾpu/	wiki
anticristo	/ɐ̃tikɾiʃtu/	wiki
antologia	/ɐ̃toloʒiɐ/	wiki
antropomorfismo	/ɐ̃tɾɔpɔmuɾfiʒmu/	wiki
antónimo	/ɐ̃tɔnɨmu/	wiki
anunciante	/anũsjɐ̃tɯ/	wiki
análogo	/ɐnaluɣu/	wiki
anátema	/ɐnatɯmɐ/	wiki
aparelhagem	/ɐpaɾɯʎaɡɯ̃/	wiki
aposta	/ɐpɔʃtɐ/	wiki
apostar	/ɐpuʃtaɾ/	wiki
apostasia	/apoʃtɐziɐ/	wiki
aquecer	/ɐkɛseɾ/	wiki
aquecimento	/ɐkɛsimẽtu/	wiki
aquiescer	/ɐkjɛʃseɾ/	wiki
aquénio	/akɛniu/	wiki
aracaju	/aɾakaʒu/	wiki
aracnídeo	/ɐɾɐkniðju/	wiki
arbitrário	/aɾbɨtɾaɾɨu/	wiki
arcaico	/ɐɾkajku/	wiki
ardente	/ɐɾðẽtɨ/	wiki
arder	/ɐɾðeɾ/	wiki
arejar	/ɐɾɯ̽ʒaɾ/	wiki
arganaz	/aɾɡɐnas/	wiki
argumento	/ɐɾɡumẽtu/	wiki
armadilha	/ɐɾmɐdiʎɐ/	wiki
armadura	/ɐɾmɐðuɾɐ/	wiki
aromático	/ɐɾumatiku/	wiki
arquiteto	/ɐɾkitɛtu/	wiki
arroba	/ɐʁoβɐ/	wiki
artesão	/aɾtɯzɐ̃w/	wiki
aríete	/ɐɾietɨ/	wiki
assincronia	/ɐsĩkɾoniɐ/	wiki
astato	/ɐʃtatʊ/	wiki
asterisco	/ɐʃtɨɾiʃku/	wiki
ata	/atɐ/	wiki
atabalhoado	/ɐtɐβɐʎwaðu/	wiki
atalho	/ɐtaʎʊ/	wiki
ateu	/ɐtew/	wiki
atirar	/ɐtiɾaɾ/	wiki
atol	/ɐtɔɫ/	wiki
atómico	/ɐtɔmɨkʊ/	wiki
auditório	/awðitɔɾju/	wiki
auga	/awɣɐ/	wiki
austríaco	/awʃtɾiɐku/	wiki
avareza	/avɐɾezɐ/	wiki
aventura	/ɐvẽtuɾɐ/	wiki
aviso	/ɐvizu/	wiki
avó	/əvɔ/	wiki
axioma	/aksɨomɐ/	wiki
azeda	/ɐzedɐ/	wiki
azeda	/ɐzɛdɐ/	wiki
azerbaijano	/ɐzɨɾβɐjʒɐnu/	wiki
azimute	/ɐzimutɨ/	wiki
bacará	/bakɐɾa/	wiki
bacteriologia	/bɐktɛɾɨʊloʒiɐ/	wiki
bactéria	/bɐktɛɾɨɐ/	wiki
bacu	/baku/	wiki
bahia	/baiɐ/	wiki
balancé	/balɐ̃sɛ/	wiki
bambara	/bɐ̃baɾɐ/	wiki
berrar	/bɯʀaɾ/	wiki
bobo	/bobu/	wiki
bobo	/boβu/	wiki
bonde	/bõdɨ/	wiki
brio	/bɾiu/	wiki
cadeiras	/kɐðɐjɾɐʃ/	wiki
calda	/kaɫðɐ/	wiki
canberra	/kɐ̃beʁa/	wiki
candomblé	/kɐ̃dõmblɛ/	wiki
caril	/kɐɾiɫ/	wiki
casado	/kɐzaðu/	wiki
chegar	/ʃɨɣaɾ/	wiki
coelho	/kueʎu/	wiki
coelho	/kweʎu/	wiki
colheita	/kuʎejtɐ/	wiki
comigo	/kumiɣu/	wiki
concha	/kõw̃ʃɐ/	wiki
concha	/kõʃɐ/	wiki
conjugar	/kõʒuɡaɾ/	wiki
controlador	/kõtɾulɐðoɾ/	wiki
dalmática	/ðalmatikɐ/	wiki
decágono	/dɨkaɣunu/	wiki
deem	/ðeɐ̃j/	wiki
deixando	/dejʃɐ̃du/	wiki
desaconselháveis	/dɯ̽zəkõsɨʎävɛi̯ʃ/	wiki
desaconselhável	/dɯ̽zəkõsɨʎävɛɫ/	wiki
desagradável	/dɯ̽zəɣɾəðävɛɫ/	wiki
desajeitado	/dzɨʒei̯taðʊ/	wiki
desconsolar	/dʒiskõsolar/	wiki
dever	/d̪ëveχ/	wiki
digo	/diɣu/	wiki
dividir	/diviðiɾ/	wiki
dividir	/dɨviðiɾ/	wiki
dor	/d̪oɾ/	wiki
dum	/ðũ/	wiki
déficit	/dɛfisiti/	wiki
déficit	/dɛfisit͡ʃi/	wiki
dêem	/ðeɐ̃j/	wiki
dívida	/diviðɐ/	wiki
encantado	/ẽkɐ̃taðu/	wiki
erguer	/eɾɣeɾ/	wiki
escudo	/iʃkuðu/	wiki
esfera	/iʃfɛɾɐ/	wiki
esfera	/ɨʃfɛɾɐ/	wiki
espada	/ɨʃpaðɐ/	wiki
espadas	/iʃpaðɐʃ/	wiki
espectador	/iʃpɛktɐðoɾ/	wiki
estúpido	/iʃtupiðu/	wiki
exceção	/iʃsɛsɐ̃w̃/	wiki
exceção	/ɐjʃsɛsɐ̃w̃/	wiki
exceção	/ʃɛsɐ̃w̃/	wiki
facebook	/fejzβuk/	wiki
figo	/fiɣu/	wiki
figueira	/fiɣejɾɐ/	wiki
figueira	/fiɣɐjɾɐ/	wiki
figueiral	/fiɣejɾaɫ/	wiki
figueiral	/fiɣɐjɾaɫ/	wiki
figueiredo	/fiɣejɾeðu/	wiki
figueiredo	/fiɣɐjɾeðu/	wiki
foder	/fuðeɾ/	wiki
fígado	/fiɡɐdʊ/	wiki
fígado	/fiɣɐðu/	wiki
gaita	/ɡajtɐ/	wiki
garra	/ɡaʁɐ/	wiki
gear	/ʒiaɾ/	wiki
gerar	/ʒɯ̽ɾaɾ/	wiki
gosto	/ɡoʃtu/	wiki
gosto	/ɡɔʃtu/	wiki
gritar	/ɣɾitaɾ/	wiki
grudar	/ɡɾudaɾ/	wiki
guadiana	/ɡwɐðjɐnɐ/	wiki
guaiamum	/ɡwajamũŋ̞ʷ/	wiki
idiota	/iðjɔtɐ/	wiki
indivíduo	/ĩdiviðuu/	wiki
indivíduo	/ĩdiviðwu/	wiki
jardins	/ʒɐɾdĩʃ/	wiki
lua	/l̪uə̤/	wiki
malevolente	/mɐlɨvulẽtɨ/	wiki
matemática	/mɐtɨmatikɐ/	wiki
medonho	/mɨðoɲu/	wiki
melga	/mɛɫɡɐ/	wiki
merda	/mɛɾðɐ/	wiki
metrô	/mët̪ɾo/	wiki
mirífico	/mirifiku/	wiki
moeda	/mwɛðɐ/	wiki
moçárabe	/musaɾɐβɨ/	wiki
mudéjar	/muðɛʒaɾ/	wiki
máximo	/masimʊ/	wiki
máximo	/masʲmʊ/	wiki
naturalmente	/nɐtuɾaɫmẽtɨ/	wiki
necedade	/nɨsɨðaðɨ/	wiki
nescidade	/nɨsiðaðɨ/	wiki
nescidade	/nɨʃiðaðɨ/	wiki
nescidade	/nɨʃsiðaðɨ/	wiki
nevada	/nɨvaðɐ/	wiki
odiana	/ɔðjɐnɐ/	wiki
olho	/oʎʊ/	wiki
olho	/ɔʎʊ/	wiki
orgulhar	/oɾɣuʎaɾ/	wiki
orgulhar	/ɔɾɣuʎaɾ/	wiki
penedo	/pɨneðu/	wiki
peninsular	/penij̃sulaɾ/	wiki
peninsular	/penij̃sulaχ/	wiki
perdoar	/pɨɾðwaɾ/	wiki
perdão	/pɨɾðɐ̃w̃/	wiki
piroca	/piɾɔkə/	wiki
pombo	/põbu/	wiki
porre	/pɔhɪ/	wiki
prudente	/pɾuðẽtɨ/	wiki
pulcro	/pul̺kr̺u/	wiki
rabo	/ʁaβu/	wiki
repolho	/ʁɨpoʎʊ/	wiki
ribeiro	/ʁiβɐjɾu/	wiki
rodrigues	/ʁuðɾiɣɨʃ/	wiki
rosto	/ʁoʃtɯ̥̽/	wiki
sabe	/saβɨ/	wiki
sabor	/sɐβoɾ/	wiki
saborear	/sɐβuɾjaɾ/	wiki
seguir	/sɨɣiɾ/	wiki
sergipe	/sɛʁʒipi/	wiki
soco	/soku/	wiki
soco	/sɔku/	wiki
supermercado	/supɛɾmɨɾkaðu/	wiki
tardar	/tɐɾdaɾ/	wiki
tinhoso	/t͡ʃĩj̃ozu/	wiki
touro	/towɾu/	wiki
trindade	/tɾĩdaðɨ/	wiki
trágica	/traʒika/	wiki
vendo	/vẽdu/	wiki
ventas	/vẽtɐʃ/	wiki
vogal	/vuɡaɫ/	wiki
xastre	/ʃaɕt̪ɾɯ/	wiki
ácaro	/akɐɾʊ/	wiki
ácido	/asidu/	wiki
ácido	/asiðu/	wiki
água	/aɣwɐ/	wiki
â	/ɐ/	wiki
â	/ɐ̃/	wiki
â	/ə/	wiki
â	/ə̃/	wiki
â	/ɜ/	wiki
â	/ɜ̃/	wiki
ímã	/imɐ̃/	wiki
ímãs	/imɐ̃ʃ/	wiki
